Abrangência;Cargo;Sexo;Qt Candidatos;Eleito;2º Turno;Não Eleito
ABADIA DE GOIÁS;Vereador;Masculino;46;8;0;38
ABADIA DE GOIÁS;Vereador;Feminino;19;1;0;18
ABADIA DOS DOURADOS;Vereador;Masculino;31;8;0;23
ABADIA DOS DOURADOS;Vereador;Feminino;16;1;0;15
ABADIÂNIA;Vereador;Masculino;39;11;0;28
ABADIÂNIA;Vereador;Feminino;21;0;0;21
ABAETÉ;Vereador;Masculino;35;8;0;27
ABAETÉ;Vereador;Feminino;19;1;0;18
ABAETETUBA;Vereador;Masculino;175;13;0;162
ABAETETUBA;Vereador;Feminino;82;2;0;80
ABAIARA;Vereador;Masculino;14;8;0;6
ABAIARA;Vereador;Feminino;7;1;0;6
ABAÍRA;Vereador;Masculino;19;8;0;11
ABAÍRA;Vereador;Feminino;10;1;0;9
ABARÉ;Vereador;Masculino;29;7;0;22
ABARÉ;Vereador;Feminino;14;4;0;10
ABATIÁ;Vereador;Masculino;31;7;0;24
ABATIÁ;Vereador;Feminino;12;2;0;10
ABDON BATISTA;Vereador;Masculino;11;9;0;2
ABDON BATISTA;Vereador;Feminino;6;0;0;6
ABEL FIGUEIREDO;Vereador;Masculino;31;7;0;24
ABEL FIGUEIREDO;Vereador;Feminino;15;2;0;13
ABELARDO LUZ;Vereador;Masculino;30;10;0;20
ABELARDO LUZ;Vereador;Feminino;13;1;0;12
ABRE CAMPO;Vereador;Masculino;24;9;0;15
ABRE CAMPO;Vereador;Feminino;12;0;0;12
ABREU E LIMA;Vereador;Masculino;157;10;0;147
ABREU E LIMA;Vereador;Feminino;71;1;0;70
ABREULÂNDIA;Vereador;Masculino;18;7;0;11
ABREULÂNDIA;Vereador;Feminino;14;2;0;12
ACAIACA;Vereador;Masculino;30;8;0;22
ACAIACA;Vereador;Feminino;15;1;0;14
AÇAILÂNDIA;Vereador;Masculino;123;14;0;109
AÇAILÂNDIA;Vereador;Feminino;43;3;0;40
ACAJUTIBA;Vereador;Masculino;55;8;0;47
ACAJUTIBA;Vereador;Feminino;27;1;0;26
ACARÁ;Vereador;Masculino;122;10;0;112
ACARÁ;Vereador;Feminino;60;3;0;57
ACARAPE;Vereador;Masculino;62;8;0;54
ACARAPE;Vereador;Feminino;33;1;0;32
ACARI;Vereador;Masculino;19;6;0;13
ACARI;Vereador;Feminino;8;3;0;5
ACAUÃ;Vereador;Masculino;14;7;0;7
ACAUÃ;Vereador;Feminino;6;2;0;4
ACEGUÁ;Vereador;Masculino;23;7;0;16
ACEGUÁ;Vereador;Feminino;12;2;0;10
ACOPIARA;Vereador;Masculino;38;11;0;27
ACOPIARA;Vereador;Feminino;16;4;0;12
ACORIZAL;Vereador;Masculino;28;7;0;21
ACORIZAL;Vereador;Feminino;14;2;0;12
ACRELÂNDIA;Vereador;Masculino;58;8;0;50
ACRELÂNDIA;Vereador;Feminino;28;1;0;27
ACREÚNA;Vereador;Masculino;54;10;0;44
ACREÚNA;Vereador;Feminino;24;1;0;23
AÇUCENA;Vereador;Masculino;51;8;0;43
AÇUCENA;Vereador;Feminino;25;1;0;24
ADAMANTINA;Vereador;Masculino;57;7;0;50
ADAMANTINA;Vereador;Feminino;28;2;0;26
ADELÂNDIA;Vereador;Masculino;20;7;0;13
ADELÂNDIA;Vereador;Feminino;11;2;0;9
ADOLFO;Vereador;Masculino;35;8;0;27
ADOLFO;Vereador;Feminino;25;1;0;24
ADRIANÓPOLIS;Vereador;Masculino;24;9;0;15
ADRIANÓPOLIS;Vereador;Feminino;12;0;0;12
ADUSTINA;Vereador;Masculino;20;6;0;14
ADUSTINA;Vereador;Feminino;9;3;0;6
AFOGADOS DA INGAZEIRA;Vereador;Masculino;38;12;0;26
AFOGADOS DA INGAZEIRA;Vereador;Feminino;19;1;0;18
AFONSO BEZERRA;Vereador;Masculino;31;9;0;22
AFONSO BEZERRA;Vereador;Feminino;13;0;0;13
AFONSO CLÁUDIO;Vereador;Masculino;36;8;0;28
AFONSO CLÁUDIO;Vereador;Feminino;18;1;0;17
AFONSO CUNHA;Vereador;Masculino;37;7;0;30
AFONSO CUNHA;Vereador;Feminino;17;2;0;15
AFRÂNIO;Vereador;Masculino;30;9;0;21
AFRÂNIO;Vereador;Feminino;14;2;0;12
AFUÁ;Vereador;Masculino;41;7;0;34
AFUÁ;Vereador;Feminino;20;4;0;16
AGRESTINA;Vereador;Masculino;45;9;0;36
AGRESTINA;Vereador;Feminino;21;2;0;19
AGRICOLÂNDIA;Vereador;Masculino;18;7;0;11
AGRICOLÂNDIA;Vereador;Feminino;10;2;0;8
AGROLÂNDIA;Vereador;Masculino;26;9;0;17
AGROLÂNDIA;Vereador;Feminino;13;0;0;13
AGRONÔMICA;Vereador;Masculino;19;9;0;10
AGRONÔMICA;Vereador;Feminino;10;0;0;10
ÁGUA AZUL DO NORTE;Vereador;Masculino;40;9;0;31
ÁGUA AZUL DO NORTE;Vereador;Feminino;20;2;0;18
ÁGUA BOA;Vereador;Masculino;110;20;0;90
ÁGUA BOA;Vereador;Feminino;53;2;0;51
ÁGUA BRANCA;Vereador;Masculino;84;24;0;60
ÁGUA BRANCA;Vereador;Feminino;42;7;0;35
ÁGUA CLARA;Vereador;Masculino;50;7;0;43
ÁGUA CLARA;Vereador;Feminino;25;2;0;23
ÁGUA COMPRIDA;Vereador;Masculino;17;7;0;10
ÁGUA COMPRIDA;Vereador;Feminino;7;2;0;5
ÁGUA DOCE;Vereador;Masculino;21;6;0;15
ÁGUA DOCE;Vereador;Feminino;12;3;0;9
ÁGUA DOCE DO MARANHÃO;Vereador;Masculino;38;8;0;30
ÁGUA DOCE DO MARANHÃO;Vereador;Feminino;17;1;0;16
ÁGUA DOCE DO NORTE;Vereador;Masculino;39;9;0;30
ÁGUA DOCE DO NORTE;Vereador;Feminino;19;0;0;19
ÁGUA FRIA;Vereador;Masculino;41;11;0;30
ÁGUA FRIA;Vereador;Feminino;18;0;0;18
ÁGUA FRIA DE GOIÁS;Vereador;Masculino;32;9;0;23
ÁGUA FRIA DE GOIÁS;Vereador;Feminino;16;0;0;16
ÁGUA LIMPA;Vereador;Masculino;19;9;0;10
ÁGUA LIMPA;Vereador;Feminino;9;0;0;9
ÁGUA NOVA;Vereador;Masculino;9;6;0;3
ÁGUA NOVA;Vereador;Feminino;6;3;0;3
ÁGUA PRETA;Vereador;Masculino;54;10;0;44
ÁGUA PRETA;Vereador;Feminino;24;1;0;23
ÁGUA SANTA;Vereador;Masculino;14;7;0;7
ÁGUA SANTA;Vereador;Feminino;7;2;0;5
AGUAÍ;Vereador;Masculino;122;13;0;109
AGUAÍ;Vereador;Feminino;67;0;0;67
AGUANIL;Vereador;Masculino;33;9;0;24
AGUANIL;Vereador;Feminino;18;0;0;18
ÁGUAS BELAS;Vereador;Masculino;59;12;0;47
ÁGUAS BELAS;Vereador;Feminino;29;0;0;29
ÁGUAS DA PRATA;Vereador;Masculino;38;7;0;31
ÁGUAS DA PRATA;Vereador;Feminino;20;2;0;18
ÁGUAS DE CHAPECÓ;Vereador;Masculino;20;8;0;12
ÁGUAS DE CHAPECÓ;Vereador;Feminino;10;1;0;9
ÁGUAS DE LINDÓIA;Vereador;Masculino;69;9;0;60
ÁGUAS DE LINDÓIA;Vereador;Feminino;32;2;0;30
ÁGUAS DE SANTA BÁRBARA;Vereador;Masculino;42;8;0;34
ÁGUAS DE SANTA BÁRBARA;Vereador;Feminino;20;1;0;19
ÁGUAS DE SÃO PEDRO;Vereador;Masculino;28;8;0;20
ÁGUAS DE SÃO PEDRO;Vereador;Feminino;16;1;0;15
ÁGUAS FORMOSAS;Vereador;Masculino;54;11;0;43
ÁGUAS FORMOSAS;Vereador;Feminino;26;0;0;26
ÁGUAS FRIAS;Vereador;Masculino;9;7;0;2
ÁGUAS FRIAS;Vereador;Feminino;4;2;0;2
ÁGUAS LINDAS DE GOIÁS;Vereador;Masculino;161;10;0;151
ÁGUAS LINDAS DE GOIÁS;Vereador;Feminino;65;3;0;62
ÁGUAS MORNAS;Vereador;Masculino;20;7;0;13
ÁGUAS MORNAS;Vereador;Feminino;9;2;0;7
ÁGUAS VERMELHAS;Vereador;Masculino;35;8;0;27
ÁGUAS VERMELHAS;Vereador;Feminino;19;1;0;18
AGUDO;Vereador;Masculino;24;9;0;15
AGUDO;Vereador;Feminino;12;0;0;12
AGUDOS;Vereador;Masculino;78;13;0;65
AGUDOS;Vereador;Feminino;33;0;0;33
AGUDOS DO SUL;Vereador;Masculino;47;8;0;39
AGUDOS DO SUL;Vereador;Feminino;25;1;0;24
ÁGUIA BRANCA;Vereador;Masculino;34;8;0;26
ÁGUIA BRANCA;Vereador;Feminino;17;1;0;16
AGUIAR;Vereador;Masculino;12;8;0;4
AGUIAR;Vereador;Feminino;6;1;0;5
AGUIARNÓPOLIS;Vereador;Masculino;20;9;0;11
AGUIARNÓPOLIS;Vereador;Feminino;12;0;0;12
AIMORÉS;Vereador;Masculino;56;9;0;47
AIMORÉS;Vereador;Feminino;26;2;0;24
AIQUARA;Vereador;Masculino;27;9;0;18
AIQUARA;Vereador;Feminino;18;0;0;18
AIUABA;Vereador;Masculino;30;9;0;21
AIUABA;Vereador;Feminino;13;2;0;11
AIURUOCA;Vereador;Masculino;37;9;0;28
AIURUOCA;Vereador;Feminino;17;0;0;17
AJURICABA;Vereador;Masculino;19;6;0;13
AJURICABA;Vereador;Feminino;11;3;0;8
ALAGOA;Vereador;Masculino;18;7;0;11
ALAGOA;Vereador;Feminino;10;2;0;8
ALAGOA GRANDE;Vereador;Masculino;41;11;0;30
ALAGOA GRANDE;Vereador;Feminino;19;0;0;19
ALAGOA NOVA;Vereador;Masculino;37;8;0;29
ALAGOA NOVA;Vereador;Feminino;18;3;0;15
ALAGOINHA;Vereador;Masculino;42;14;0;28
ALAGOINHA;Vereador;Feminino;21;4;0;17
ALAGOINHA DO PIAUÍ;Vereador;Masculino;7;6;0;1
ALAGOINHA DO PIAUÍ;Vereador;Feminino;4;3;0;1
ALAGOINHAS;Vereador;Masculino;190;16;0;174
ALAGOINHAS;Vereador;Feminino;68;1;0;67
ALAMBARI;Vereador;Masculino;39;9;0;30
ALAMBARI;Vereador;Feminino;16;0;0;16
ALBERTINA;Vereador;Masculino;31;7;0;24
ALBERTINA;Vereador;Feminino;16;2;0;14
ALCÂNTARA;Vereador;Masculino;70;10;0;60
ALCÂNTARA;Vereador;Feminino;33;1;0;32
ALCÂNTARAS;Vereador;Masculino;23;8;0;15
ALCÂNTARAS;Vereador;Feminino;11;1;0;10
ALCANTIL;Vereador;Masculino;34;7;0;27
ALCANTIL;Vereador;Feminino;16;2;0;14
ALCINÓPOLIS;Vereador;Masculino;23;8;0;15
ALCINÓPOLIS;Vereador;Feminino;12;1;0;11
ALCOBAÇA;Vereador;Masculino;78;9;0;69
ALCOBAÇA;Vereador;Feminino;39;2;0;37
ALDEIAS ALTAS;Vereador;Masculino;70;8;0;62
ALDEIAS ALTAS;Vereador;Feminino;33;3;0;30
ALECRIM;Vereador;Masculino;13;8;0;5
ALECRIM;Vereador;Feminino;8;1;0;7
ALEGRE;Vereador;Masculino;59;13;0;46
ALEGRE;Vereador;Feminino;25;0;0;25
ALEGRETE;Vereador;Masculino;85;11;0;74
ALEGRETE;Vereador;Feminino;39;4;0;35
ALEGRETE DO PIAUÍ;Vereador;Masculino;15;6;0;9
ALEGRETE DO PIAUÍ;Vereador;Feminino;7;3;0;4
ALEGRIA;Vereador;Masculino;22;8;0;14
ALEGRIA;Vereador;Feminino;10;1;0;9
ALÉM PARAÍBA;Vereador;Masculino;113;12;0;101
ALÉM PARAÍBA;Vereador;Feminino;56;1;0;55
ALENQUER;Vereador;Masculino;102;14;0;88
ALENQUER;Vereador;Feminino;48;1;0;47
ALEXANDRIA;Vereador;Masculino;21;9;0;12
ALEXANDRIA;Vereador;Feminino;11;0;0;11
ALEXÂNIA;Vereador;Masculino;96;11;0;85
ALEXÂNIA;Vereador;Feminino;49;0;0;49
ALFENAS;Vereador;Masculino;126;12;0;114
ALFENAS;Vereador;Feminino;61;0;0;61
ALFREDO CHAVES;Vereador;Masculino;40;9;0;31
ALFREDO CHAVES;Vereador;Feminino;23;0;0;23
ALFREDO MARCONDES;Vereador;Masculino;28;8;0;20
ALFREDO MARCONDES;Vereador;Feminino;14;1;0;13
ALFREDO VASCONCELOS;Vereador;Masculino;37;8;0;29
ALFREDO VASCONCELOS;Vereador;Feminino;19;1;0;18
ALFREDO WAGNER;Vereador;Masculino;22;9;0;13
ALFREDO WAGNER;Vereador;Feminino;11;0;0;11
ALGODÃO DE JANDAÍRA;Vereador;Masculino;21;6;0;15
ALGODÃO DE JANDAÍRA;Vereador;Feminino;10;3;0;7
ALHANDRA;Vereador;Masculino;41;9;0;32
ALHANDRA;Vereador;Feminino;19;2;0;17
ALIANÇA;Vereador;Masculino;42;8;0;34
ALIANÇA;Vereador;Feminino;21;3;0;18
ALIANÇA DO TOCANTINS;Vereador;Masculino;20;7;0;13
ALIANÇA DO TOCANTINS;Vereador;Feminino;10;2;0;8
ALMADINA;Vereador;Masculino;21;6;0;15
ALMADINA;Vereador;Feminino;8;3;0;5
ALMAS;Vereador;Masculino;19;5;0;14
ALMAS;Vereador;Feminino;6;4;0;2
ALMEIRIM;Vereador;Masculino;64;8;0;56
ALMEIRIM;Vereador;Feminino;33;1;0;32
ALMENARA;Vereador;Masculino;84;11;0;73
ALMENARA;Vereador;Feminino;41;2;0;39
ALMINO AFONSO;Vereador;Masculino;16;9;0;7
ALMINO AFONSO;Vereador;Feminino;10;0;0;10
ALMIRANTE TAMANDARÉ;Vereador;Masculino;161;13;0;148
ALMIRANTE TAMANDARÉ;Vereador;Feminino;74;2;0;72
ALMIRANTE TAMANDARÉ DO SUL;Vereador;Masculino;16;4;0;12
ALMIRANTE TAMANDARÉ DO SUL;Vereador;Feminino;13;5;0;8
ALOÂNDIA;Vereador;Masculino;19;9;0;10
ALOÂNDIA;Vereador;Feminino;9;0;0;9
ALPERCATA;Vereador;Masculino;65;8;0;57
ALPERCATA;Vereador;Feminino;33;1;0;32
ALPESTRE;Vereador;Masculino;20;8;0;12
ALPESTRE;Vereador;Feminino;10;1;0;9
ALPINÓPOLIS;Vereador;Masculino;54;6;0;48
ALPINÓPOLIS;Vereador;Feminino;32;3;0;29
ALTA FLORESTA;Vereador;Masculino;59;10;0;49
ALTA FLORESTA;Vereador;Feminino;28;1;0;27
ALTA FLORESTA DO OESTE;Vereador;Masculino;61;8;0;53
ALTA FLORESTA DO OESTE;Vereador;Feminino;25;2;0;23
ALTAIR;Vereador;Masculino;28;7;0;21
ALTAIR;Vereador;Feminino;13;2;0;11
ALTAMIRA;Vereador;Masculino;101;12;0;89
ALTAMIRA;Vereador;Feminino;39;3;0;36
ALTAMIRA DO MARANHÃO;Vereador;Masculino;20;6;0;14
ALTAMIRA DO MARANHÃO;Vereador;Feminino;15;3;0;12
ALTAMIRA DO PARANÁ;Vereador;Masculino;22;8;0;14
ALTAMIRA DO PARANÁ;Vereador;Feminino;12;1;0;11
ALTANEIRA;Vereador;Masculino;11;6;0;5
ALTANEIRA;Vereador;Feminino;7;3;0;4
ALTEROSA;Vereador;Masculino;47;9;0;38
ALTEROSA;Vereador;Feminino;27;0;0;27
ALTINHO;Vereador;Masculino;24;10;0;14
ALTINHO;Vereador;Feminino;11;1;0;10
ALTINÓPOLIS;Vereador;Masculino;71;11;0;60
ALTINÓPOLIS;Vereador;Feminino;34;0;0;34
ALTO ALEGRE;Vereador;Masculino;82;24;0;58
ALTO ALEGRE;Vereador;Feminino;40;3;0;37
ALTO ALEGRE DO MARANHÃO;Vereador;Masculino;37;8;0;29
ALTO ALEGRE DO MARANHÃO;Vereador;Feminino;23;3;0;20
ALTO ALEGRE DO PINDARÉ;Vereador;Masculino;61;12;0;49
ALTO ALEGRE DO PINDARÉ;Vereador;Feminino;25;1;0;24
ALTO ALEGRE DOS PARECIS;Vereador;Masculino;48;8;0;40
ALTO ALEGRE DOS PARECIS;Vereador;Feminino;24;1;0;23
ALTO ARAGUAIA;Vereador;Masculino;34;8;0;26
ALTO ARAGUAIA;Vereador;Feminino;19;3;0;16
ALTO BELA VISTA;Vereador;Masculino;21;5;0;16
ALTO BELA VISTA;Vereador;Feminino;11;4;0;7
ALTO BOA VISTA;Vereador;Masculino;18;8;0;10
ALTO BOA VISTA;Vereador;Feminino;9;1;0;8
ALTO CAPARAÓ;Vereador;Masculino;32;8;0;24
ALTO CAPARAÓ;Vereador;Feminino;21;1;0;20
ALTO DO RODRIGUES;Vereador;Masculino;21;7;0;14
ALTO DO RODRIGUES;Vereador;Feminino;13;2;0;11
ALTO FELIZ;Vereador;Masculino;19;5;0;14
ALTO FELIZ;Vereador;Feminino;10;4;0;6
ALTO GARÇAS;Vereador;Masculino;24;8;0;16
ALTO GARÇAS;Vereador;Feminino;13;1;0;12
ALTO HORIZONTE;Vereador;Masculino;28;5;0;23
ALTO HORIZONTE;Vereador;Feminino;17;4;0;13
ALTO JEQUITIBÁ;Vereador;Masculino;32;6;0;26
ALTO JEQUITIBÁ;Vereador;Feminino;16;3;0;13
ALTO LONGÁ;Vereador;Masculino;30;9;0;21
ALTO LONGÁ;Vereador;Feminino;14;0;0;14
ALTO PARAGUAI;Vereador;Masculino;36;8;0;28
ALTO PARAGUAI;Vereador;Feminino;16;1;0;15
ALTO PARAÍSO;Vereador;Masculino;73;17;0;56
ALTO PARAÍSO;Vereador;Feminino;38;3;0;35
ALTO PARAÍSO DE GOIÁS;Vereador;Masculino;37;8;0;29
ALTO PARAÍSO DE GOIÁS;Vereador;Feminino;13;1;0;12
ALTO PARANÁ;Vereador;Masculino;33;6;0;27
ALTO PARANÁ;Vereador;Feminino;16;3;0;13
ALTO PARNAÍBA;Vereador;Masculino;45;8;0;37
ALTO PARNAÍBA;Vereador;Feminino;23;1;0;22
ALTO PIQUIRI;Vereador;Masculino;39;9;0;30
ALTO PIQUIRI;Vereador;Feminino;16;0;0;16
ALTO RIO DOCE;Vereador;Masculino;48;8;0;40
ALTO RIO DOCE;Vereador;Feminino;24;1;0;23
ALTO RIO NOVO;Vereador;Masculino;30;6;0;24
ALTO RIO NOVO;Vereador;Feminino;16;3;0;13
ALTO SANTO;Vereador;Masculino;30;8;0;22
ALTO SANTO;Vereador;Feminino;14;3;0;11
ALTO TAQUARI;Vereador;Masculino;38;7;0;31
ALTO TAQUARI;Vereador;Feminino;20;2;0;18
ALTÔNIA;Vereador;Masculino;51;8;0;43
ALTÔNIA;Vereador;Feminino;28;1;0;27
ALTOS;Vereador;Masculino;73;13;0;60
ALTOS;Vereador;Feminino;33;0;0;33
ALUMÍNIO;Vereador;Masculino;74;8;0;66
ALUMÍNIO;Vereador;Feminino;38;1;0;37
ALVARÃES;Vereador;Masculino;57;7;0;50
ALVARÃES;Vereador;Feminino;18;2;0;16
ALVARENGA;Vereador;Masculino;19;8;0;11
ALVARENGA;Vereador;Feminino;9;1;0;8
ÁLVARES FLORENCE;Vereador;Masculino;24;6;0;18
ÁLVARES FLORENCE;Vereador;Feminino;11;3;0;8
ÁLVARES MACHADO;Vereador;Masculino;54;8;0;46
ÁLVARES MACHADO;Vereador;Feminino;29;1;0;28
ÁLVARO DE CARVALHO;Vereador;Masculino;35;9;0;26
ÁLVARO DE CARVALHO;Vereador;Feminino;15;0;0;15
ALVINLÂNDIA;Vereador;Masculino;24;8;0;16
ALVINLÂNDIA;Vereador;Feminino;13;1;0;12
ALVINÓPOLIS;Vereador;Masculino;62;10;0;52
ALVINÓPOLIS;Vereador;Feminino;33;1;0;32
ALVORADA;Vereador;Masculino;173;22;0;151
ALVORADA;Vereador;Feminino;81;4;0;77
ALVORADA DE MINAS;Vereador;Masculino;46;9;0;37
ALVORADA DE MINAS;Vereador;Feminino;25;0;0;25
ALVORADA DO GURGUÉIA;Vereador;Masculino;20;8;0;12
ALVORADA DO GURGUÉIA;Vereador;Feminino;9;1;0;8
ALVORADA DO NORTE;Vereador;Masculino;27;8;0;19
ALVORADA DO NORTE;Vereador;Feminino;13;1;0;12
ALVORADA DO OESTE;Vereador;Masculino;53;9;0;44
ALVORADA DO OESTE;Vereador;Feminino;27;2;0;25
ALVORADA DO SUL;Vereador;Masculino;50;9;0;41
ALVORADA DO SUL;Vereador;Feminino;23;0;0;23
AMAJARI;Vereador;Masculino;46;8;0;38
AMAJARI;Vereador;Feminino;23;1;0;22
AMAMBAI;Vereador;Masculino;57;13;0;44
AMAMBAI;Vereador;Feminino;26;0;0;26
AMAPÁ;Vereador;Masculino;40;8;0;32
AMAPÁ;Vereador;Feminino;18;1;0;17
AMAPÁ DO MARANHÃO;Vereador;Masculino;44;8;0;36
AMAPÁ DO MARANHÃO;Vereador;Feminino;28;1;0;27
AMAPORÃ;Vereador;Masculino;34;9;0;25
AMAPORÃ;Vereador;Feminino;18;0;0;18
AMARAJI;Vereador;Masculino;69;7;0;62
AMARAJI;Vereador;Feminino;21;2;0;19
AMARAL FERRADOR;Vereador;Masculino;23;8;0;15
AMARAL FERRADOR;Vereador;Feminino;11;1;0;10
AMARALINA;Vereador;Masculino;30;9;0;21
AMARALINA;Vereador;Feminino;16;0;0;16
AMARANTE;Vereador;Masculino;44;10;0;34
AMARANTE;Vereador;Feminino;21;1;0;20
AMARANTE DO MARANHÃO;Vereador;Masculino;53;9;0;44
AMARANTE DO MARANHÃO;Vereador;Feminino;25;4;0;21
AMARGOSA;Vereador;Masculino;76;11;0;65
AMARGOSA;Vereador;Feminino;32;2;0;30
AMATURÁ;Vereador;Masculino;44;9;0;35
AMATURÁ;Vereador;Feminino;18;0;0;18
AMÉLIA RODRIGUES;Vereador;Masculino;83;8;0;75
AMÉLIA RODRIGUES;Vereador;Feminino;39;3;0;36
AMÉRICA DOURADA;Vereador;Masculino;30;11;0;19
AMÉRICA DOURADA;Vereador;Feminino;14;0;0;14
AMERICANA;Vereador;Masculino;203;18;0;185
AMERICANA;Vereador;Feminino;93;1;0;92
AMERICANO DO BRASIL;Vereador;Masculino;27;8;0;19
AMERICANO DO BRASIL;Vereador;Feminino;12;1;0;11
AMÉRICO BRASILIENSE;Vereador;Masculino;118;11;0;107
AMÉRICO BRASILIENSE;Vereador;Feminino;54;2;0;52
AMÉRICO DE CAMPOS;Vereador;Masculino;22;8;0;14
AMÉRICO DE CAMPOS;Vereador;Feminino;11;1;0;10
AMETISTA DO SUL;Vereador;Masculino;10;9;0;1
AMETISTA DO SUL;Vereador;Feminino;4;0;0;4
AMONTADA;Vereador;Masculino;61;11;0;50
AMONTADA;Vereador;Feminino;29;2;0;27
AMORINÓPOLIS;Vereador;Masculino;18;9;0;9
AMORINÓPOLIS;Vereador;Feminino;7;0;0;7
AMPARO;Vereador;Masculino;97;19;0;78
AMPARO;Vereador;Feminino;48;2;0;46
AMPARO DE SÃO FRANCISCO;Vereador;Masculino;23;8;0;15
AMPARO DE SÃO FRANCISCO;Vereador;Feminino;11;1;0;10
AMPARO DO SERRA;Vereador;Masculino;33;9;0;24
AMPARO DO SERRA;Vereador;Feminino;19;0;0;19
AMPÉRE;Vereador;Masculino;29;7;0;22
AMPÉRE;Vereador;Feminino;14;2;0;12
ANADIA;Vereador;Masculino;27;11;0;16
ANADIA;Vereador;Feminino;12;0;0;12
ANAGÉ;Vereador;Masculino;40;11;0;29
ANAGÉ;Vereador;Feminino;18;0;0;18
ANAHY;Vereador;Masculino;12;6;0;6
ANAHY;Vereador;Feminino;8;3;0;5
ANAJÁS;Vereador;Masculino;59;10;0;49
ANAJÁS;Vereador;Feminino;28;1;0;27
ANAJATUBA;Vereador;Masculino;42;8;0;34
ANAJATUBA;Vereador;Feminino;20;3;0;17
ANALÂNDIA;Vereador;Masculino;48;9;0;39
ANALÂNDIA;Vereador;Feminino;24;0;0;24
ANAMÃ;Vereador;Masculino;33;9;0;24
ANAMÃ;Vereador;Feminino;16;0;0;16
ANANÁS;Vereador;Masculino;17;5;0;12
ANANÁS;Vereador;Feminino;14;4;0;10
ANANINDEUA;Vereador;Masculino;352;22;0;330
ANANINDEUA;Vereador;Feminino;153;3;0;150
ANÁPOLIS;Vereador;Masculino;332;20;0;312
ANÁPOLIS;Vereador;Feminino;146;3;0;143
ANAPU;Vereador;Masculino;64;8;0;56
ANAPU;Vereador;Feminino;33;1;0;32
ANAPURUS;Vereador;Masculino;29;6;0;23
ANAPURUS;Vereador;Feminino;15;3;0;12
ANASTÁCIO;Vereador;Masculino;87;10;0;77
ANASTÁCIO;Vereador;Feminino;41;1;0;40
ANAURILÂNDIA;Vereador;Masculino;39;8;0;31
ANAURILÂNDIA;Vereador;Feminino;19;1;0;18
ANCHIETA;Vereador;Masculino;77;15;0;62
ANCHIETA;Vereador;Feminino;39;5;0;34
ANDARAÍ;Vereador;Masculino;32;7;0;25
ANDARAÍ;Vereador;Feminino;15;2;0;13
ANDIRÁ;Vereador;Masculino;61;9;0;52
ANDIRÁ;Vereador;Feminino;30;0;0;30
ANDORINHA;Vereador;Masculino;51;9;0;42
ANDORINHA;Vereador;Feminino;15;0;0;15
ANDRADAS;Vereador;Masculino;63;9;0;54
ANDRADAS;Vereador;Feminino;33;0;0;33
ANDRADINA;Vereador;Masculino;158;14;0;144
ANDRADINA;Vereador;Feminino;66;1;0;65
ANDRÉ DA ROCHA;Vereador;Masculino;17;9;0;8
ANDRÉ DA ROCHA;Vereador;Feminino;8;0;0;8
ANDRELÂNDIA;Vereador;Masculino;42;7;0;35
ANDRELÂNDIA;Vereador;Feminino;20;2;0;18
ANGATUBA;Vereador;Masculino;68;7;0;61
ANGATUBA;Vereador;Feminino;34;2;0;32
ANGELÂNDIA;Vereador;Masculino;29;7;0;22
ANGELÂNDIA;Vereador;Feminino;17;2;0;15
ANGÉLICA;Vereador;Masculino;28;7;0;21
ANGÉLICA;Vereador;Feminino;14;2;0;12
ANGELIM;Vereador;Masculino;28;8;0;20
ANGELIM;Vereador;Feminino;16;1;0;15
ANGELINA;Vereador;Masculino;25;9;0;16
ANGELINA;Vereador;Feminino;12;0;0;12
ANGICAL;Vereador;Masculino;33;9;0;24
ANGICAL;Vereador;Feminino;16;0;0;16
ANGICAL DO PIAUÍ;Vereador;Masculino;29;7;0;22
ANGICAL DO PIAUÍ;Vereador;Feminino;15;2;0;13
ANGICO;Vereador;Masculino;15;7;0;8
ANGICO;Vereador;Feminino;10;2;0;8
ANGICOS;Vereador;Masculino;22;7;0;15
ANGICOS;Vereador;Feminino;12;2;0;10
ANGRA DOS REIS;Vereador;Masculino;173;12;0;161
ANGRA DOS REIS;Vereador;Feminino;85;2;0;83
ANGUERA;Vereador;Masculino;22;8;0;14
ANGUERA;Vereador;Feminino;12;1;0;11
ÂNGULO;Vereador;Masculino;32;8;0;24
ÂNGULO;Vereador;Feminino;14;1;0;13
ANHANGÜERA;Vereador;Masculino;20;9;0;11
ANHANGÜERA;Vereador;Feminino;10;0;0;10
ANHEMBI;Vereador;Masculino;28;8;0;20
ANHEMBI;Vereador;Feminino;14;1;0;13
ANHUMAS;Vereador;Masculino;29;7;0;22
ANHUMAS;Vereador;Feminino;15;2;0;13
ANICUNS;Vereador;Masculino;57;10;0;47
ANICUNS;Vereador;Feminino;28;1;0;27
ANÍSIO DE ABREU;Vereador;Masculino;21;6;0;15
ANÍSIO DE ABREU;Vereador;Feminino;11;3;0;8
ANITA GARIBALDI;Vereador;Masculino;21;9;0;12
ANITA GARIBALDI;Vereador;Feminino;9;0;0;9
ANITÁPOLIS;Vereador;Masculino;15;8;0;7
ANITÁPOLIS;Vereador;Feminino;5;1;0;4
ANORI;Vereador;Masculino;36;10;0;26
ANORI;Vereador;Feminino;19;1;0;18
ANTA GORDA;Vereador;Masculino;16;7;0;9
ANTA GORDA;Vereador;Feminino;7;2;0;5
ANTAS;Vereador;Masculino;22;11;0;11
ANTAS;Vereador;Feminino;10;0;0;10
ANTONINA;Vereador;Masculino;90;10;0;80
ANTONINA;Vereador;Feminino;41;1;0;40
ANTONINA DO NORTE;Vereador;Masculino;18;5;0;13
ANTONINA DO NORTE;Vereador;Feminino;12;4;0;8
ANTÔNIO ALMEIDA;Vereador;Masculino;22;8;0;14
ANTÔNIO ALMEIDA;Vereador;Feminino;11;1;0;10
ANTÔNIO CARDOSO;Vereador;Masculino;41;8;0;33
ANTÔNIO CARDOSO;Vereador;Feminino;18;1;0;17
ANTÔNIO CARLOS;Vereador;Masculino;64;14;0;50
ANTÔNIO CARLOS;Vereador;Feminino;31;4;0;27
ANTÔNIO DIAS;Vereador;Masculino;62;9;0;53
ANTÔNIO DIAS;Vereador;Feminino;30;0;0;30
ANTÔNIO GONÇALVES;Vereador;Masculino;22;7;0;15
ANTÔNIO GONÇALVES;Vereador;Feminino;10;2;0;8
ANTÔNIO JOÃO;Vereador;Masculino;35;7;0;28
ANTÔNIO JOÃO;Vereador;Feminino;17;2;0;15
ANTÔNIO MARTINS;Vereador;Masculino;18;9;0;9
ANTÔNIO MARTINS;Vereador;Feminino;9;0;0;9
ANTONIO OLINTO;Vereador;Masculino;23;9;0;14
ANTONIO OLINTO;Vereador;Feminino;12;0;0;12
ANTÔNIO PRADO;Vereador;Masculino;26;9;0;17
ANTÔNIO PRADO;Vereador;Feminino;13;0;0;13
ANTÔNIO PRADO DE MINAS;Vereador;Masculino;20;8;0;12
ANTÔNIO PRADO DE MINAS;Vereador;Feminino;9;1;0;8
APARECIDA;Vereador;Masculino;87;15;0;72
APARECIDA;Vereador;Feminino;39;3;0;36
APARECIDA DE GOIÂNIA;Vereador;Masculino;324;24;0;300
APARECIDA DE GOIÂNIA;Vereador;Feminino;131;1;0;130
APARECIDA DO RIO DOCE;Vereador;Masculino;20;8;0;12
APARECIDA DO RIO DOCE;Vereador;Feminino;11;1;0;10
APARECIDA DO RIO NEGRO;Vereador;Masculino;23;8;0;15
APARECIDA DO RIO NEGRO;Vereador;Feminino;12;1;0;11
APARECIDA DO TABOADO;Vereador;Masculino;62;9;0;53
APARECIDA DO TABOADO;Vereador;Feminino;32;0;0;32
APARECIDA D'OESTE;Vereador;Masculino;20;9;0;11
APARECIDA D'OESTE;Vereador;Feminino;11;0;0;11
APERIBÉ;Vereador;Masculino;42;9;0;33
APERIBÉ;Vereador;Feminino;20;0;0;20
APIACÁ;Vereador;Masculino;42;9;0;33
APIACÁ;Vereador;Feminino;24;0;0;24
APIACÁS;Vereador;Masculino;47;6;0;41
APIACÁS;Vereador;Feminino;24;3;0;21
APIAÍ;Vereador;Masculino;76;11;0;65
APIAÍ;Vereador;Feminino;36;0;0;36
APICUM-AÇU;Vereador;Masculino;41;8;0;33
APICUM-AÇU;Vereador;Feminino;19;1;0;18
APIÚNA;Vereador;Masculino;36;9;0;27
APIÚNA;Vereador;Feminino;18;0;0;18
APODI;Vereador;Masculino;48;11;0;37
APODI;Vereador;Feminino;26;2;0;24
APORÁ;Vereador;Masculino;36;6;0;30
APORÁ;Vereador;Feminino;18;3;0;15
APORÉ;Vereador;Masculino;23;6;0;17
APORÉ;Vereador;Feminino;11;3;0;8
APUAREMA;Vereador;Masculino;22;8;0;14
APUAREMA;Vereador;Feminino;7;1;0;6
APUCARANA;Vereador;Masculino;119;9;0;110
APUCARANA;Vereador;Feminino;56;2;0;54
APUÍ;Vereador;Masculino;55;9;0;46
APUÍ;Vereador;Feminino;21;0;0;21
APUIARÉS;Vereador;Masculino;29;6;0;23
APUIARÉS;Vereador;Feminino;13;3;0;10
AQUIDABÃ;Vereador;Masculino;44;10;0;34
AQUIDABÃ;Vereador;Feminino;20;1;0;19
AQUIDAUANA;Vereador;Masculino;95;12;0;83
AQUIDAUANA;Vereador;Feminino;51;1;0;50
AQUIRAZ;Vereador;Masculino;99;12;0;87
AQUIRAZ;Vereador;Feminino;43;3;0;40
ARABUTÃ;Vereador;Masculino;23;7;0;16
ARABUTÃ;Vereador;Feminino;11;2;0;9
ARAÇAGI;Vereador;Masculino;52;8;0;44
ARAÇAGI;Vereador;Feminino;28;3;0;25
ARAÇAÍ;Vereador;Masculino;23;8;0;15
ARAÇAÍ;Vereador;Feminino;12;1;0;11
ARACAJU;Vereador;Masculino;283;22;0;261
ARACAJU;Vereador;Feminino;121;2;0;119
ARAÇARIGUAMA;Vereador;Masculino;108;11;0;97
ARAÇARIGUAMA;Vereador;Feminino;48;0;0;48
ARAÇÁS;Vereador;Masculino;42;8;0;34
ARAÇÁS;Vereador;Feminino;20;1;0;19
ARACATI;Vereador;Masculino;76;11;0;65
ARACATI;Vereador;Feminino;38;4;0;34
ARACATU;Vereador;Masculino;24;7;0;17
ARACATU;Vereador;Feminino;12;2;0;10
ARAÇATUBA;Vereador;Masculino;96;9;0;87
ARAÇATUBA;Vereador;Feminino;47;3;0;44
ARACI;Vereador;Masculino;69;12;0;57
ARACI;Vereador;Feminino;36;3;0;33
ARACITABA;Vereador;Masculino;17;8;0;9
ARACITABA;Vereador;Feminino;10;1;0;9
ARACOIABA;Vereador;Masculino;46;9;0;37
ARACOIABA;Vereador;Feminino;20;2;0;18
ARAÇOIABA;Vereador;Masculino;66;10;0;56
ARAÇOIABA;Vereador;Feminino;23;1;0;22
ARAÇOIABA DA SERRA;Vereador;Masculino;66;5;0;61
ARAÇOIABA DA SERRA;Vereador;Feminino;30;4;0;26
ARACRUZ;Vereador;Masculino;147;15;0;132
ARACRUZ;Vereador;Feminino;65;2;0;63
ARAÇU;Vereador;Masculino;23;7;0;16
ARAÇU;Vereador;Feminino;12;2;0;10
ARAÇUAÍ;Vereador;Masculino;91;10;0;81
ARAÇUAÍ;Vereador;Feminino;41;1;0;40
ARAGARÇAS;Vereador;Masculino;67;9;0;58
ARAGARÇAS;Vereador;Feminino;35;2;0;33
ARAGOIÂNIA;Vereador;Masculino;38;8;0;30
ARAGOIÂNIA;Vereador;Feminino;15;1;0;14
ARAGOMINAS;Vereador;Masculino;22;8;0;14
ARAGOMINAS;Vereador;Feminino;11;1;0;10
ARAGUACEMA;Vereador;Masculino;38;8;0;30
ARAGUACEMA;Vereador;Feminino;19;1;0;18
ARAGUAÇU;Vereador;Masculino;23;7;0;16
ARAGUAÇU;Vereador;Feminino;10;2;0;8
ARAGUAIANA;Vereador;Masculino;31;9;0;22
ARAGUAIANA;Vereador;Feminino;15;0;0;15
ARAGUAÍNA;Vereador;Masculino;122;14;0;108
ARAGUAÍNA;Vereador;Feminino;56;3;0;53
ARAGUAINHA;Vereador;Masculino;14;6;0;8
ARAGUAINHA;Vereador;Feminino;8;3;0;5
ARAGUANÃ;Vereador;Masculino;67;15;0;52
ARAGUANÃ;Vereador;Feminino;37;3;0;34
ARAGUAPAZ;Vereador;Masculino;41;9;0;32
ARAGUAPAZ;Vereador;Feminino;19;0;0;19
ARAGUARI;Vereador;Masculino;136;16;0;120
ARAGUARI;Vereador;Feminino;48;1;0;47
ARAGUATINS;Vereador;Masculino;64;10;0;54
ARAGUATINS;Vereador;Feminino;14;1;0;13
ARAIOSES;Vereador;Masculino;66;10;0;56
ARAIOSES;Vereador;Feminino;29;3;0;26
ARAL MOREIRA;Vereador;Masculino;40;6;0;34
ARAL MOREIRA;Vereador;Feminino;21;3;0;18
ARAMARI;Vereador;Masculino;65;9;0;56
ARAMARI;Vereador;Feminino;32;0;0;32
ARAMBARÉ;Vereador;Masculino;33;7;0;26
ARAMBARÉ;Vereador;Feminino;18;2;0;16
ARAME;Vereador;Masculino;36;13;0;23
ARAME;Vereador;Feminino;16;0;0;16
ARAMINA;Vereador;Masculino;25;8;0;17
ARAMINA;Vereador;Feminino;13;1;0;12
ARANDU;Vereador;Masculino;49;9;0;40
ARANDU;Vereador;Feminino;24;0;0;24
ARANTINA;Vereador;Masculino;22;9;0;13
ARANTINA;Vereador;Feminino;13;0;0;13
ARAPEÍ;Vereador;Masculino;39;7;0;32
ARAPEÍ;Vereador;Feminino;20;2;0;18
ARAPIRACA;Vereador;Masculino;108;11;0;97
ARAPIRACA;Vereador;Feminino;42;4;0;38
ARAPOEMA;Vereador;Masculino;32;6;0;26
ARAPOEMA;Vereador;Feminino;17;3;0;14
ARAPONGA;Vereador;Masculino;29;8;0;21
ARAPONGA;Vereador;Feminino;14;1;0;13
ARAPONGAS;Vereador;Masculino;143;12;0;131
ARAPONGAS;Vereador;Feminino;51;3;0;48
ARAPORÃ;Vereador;Masculino;48;9;0;39
ARAPORÃ;Vereador;Feminino;24;0;0;24
ARAPOTI;Vereador;Masculino;43;8;0;35
ARAPOTI;Vereador;Feminino;17;1;0;16
ARAPUÁ;Vereador;Masculino;28;8;0;20
ARAPUÁ;Vereador;Feminino;13;1;0;12
ARAPUÃ;Vereador;Masculino;21;7;0;14
ARAPUÃ;Vereador;Feminino;11;2;0;9
ARAPUTANGA;Vereador;Masculino;58;10;0;48
ARAPUTANGA;Vereador;Feminino;27;1;0;26
ARAQUARI;Vereador;Masculino;51;10;0;41
ARAQUARI;Vereador;Feminino;27;1;0;26
ARARA;Vereador;Masculino;24;7;0;17
ARARA;Vereador;Feminino;12;2;0;10
ARARANGUÁ;Vereador;Masculino;74;15;0;59
ARARANGUÁ;Vereador;Feminino;32;0;0;32
ARARAQUARA;Vereador;Masculino;181;15;0;166
ARARAQUARA;Vereador;Feminino;82;3;0;79
ARARAS;Vereador;Masculino;129;9;0;120
ARARAS;Vereador;Feminino;63;2;0;61
ARARENDÁ;Vereador;Masculino;19;8;0;11
ARARENDÁ;Vereador;Feminino;9;1;0;8
ARARI;Vereador;Masculino;50;10;0;40
ARARI;Vereador;Feminino;22;1;0;21
ARARICÁ;Vereador;Masculino;52;9;0;43
ARARICÁ;Vereador;Feminino;28;0;0;28
ARARIPE;Vereador;Masculino;24;10;0;14
ARARIPE;Vereador;Feminino;11;1;0;10
ARARIPINA;Vereador;Masculino;79;14;0;65
ARARIPINA;Vereador;Feminino;17;1;0;16
ARARUAMA;Vereador;Masculino;161;14;0;147
ARARUAMA;Vereador;Feminino;71;3;0;68
ARARUNA;Vereador;Masculino;57;17;0;40
ARARUNA;Vereador;Feminino;30;3;0;27
ARATACA;Vereador;Masculino;47;8;0;39
ARATACA;Vereador;Feminino;21;1;0;20
ARATIBA;Vereador;Masculino;21;9;0;12
ARATIBA;Vereador;Feminino;9;0;0;9
ARATUBA;Vereador;Masculino;36;7;0;29
ARATUBA;Vereador;Feminino;20;2;0;18
ARATUÍPE;Vereador;Masculino;42;9;0;33
ARATUÍPE;Vereador;Feminino;21;0;0;21
ARAUÁ;Vereador;Masculino;41;8;0;33
ARAUÁ;Vereador;Feminino;19;1;0;18
ARAUCÁRIA;Vereador;Masculino;107;10;0;97
ARAUCÁRIA;Vereador;Feminino;50;1;0;49
ARAÚJOS;Vereador;Masculino;36;9;0;27
ARAÚJOS;Vereador;Feminino;18;0;0;18
ARAXÁ;Vereador;Masculino;110;15;0;95
ARAXÁ;Vereador;Feminino;48;0;0;48
ARCEBURGO;Vereador;Masculino;18;7;0;11
ARCEBURGO;Vereador;Feminino;9;2;0;7
ARCO-ÍRIS;Vereador;Masculino;25;7;0;18
ARCO-ÍRIS;Vereador;Feminino;17;2;0;15
ARCOS;Vereador;Masculino;118;12;0;106
ARCOS;Vereador;Feminino;56;1;0;55
ARCOVERDE;Vereador;Masculino;52;7;0;45
ARCOVERDE;Vereador;Feminino;18;3;0;15
AREADO;Vereador;Masculino;48;7;0;41
AREADO;Vereador;Feminino;17;2;0;15
AREAL;Vereador;Masculino;70;7;0;63
AREAL;Vereador;Feminino;37;2;0;35
AREALVA;Vereador;Masculino;26;7;0;19
AREALVA;Vereador;Feminino;14;2;0;12
AREIA;Vereador;Masculino;69;7;0;62
AREIA;Vereador;Feminino;26;4;0;22
AREIA BRANCA;Vereador;Masculino;121;21;0;100
AREIA BRANCA;Vereador;Feminino;59;1;0;58
AREIA DE BARAÚNAS;Vereador;Masculino;16;8;0;8
AREIA DE BARAÚNAS;Vereador;Feminino;10;1;0;9
AREIAL;Vereador;Masculino;25;9;0;16
AREIAL;Vereador;Feminino;7;0;0;7
AREIAS;Vereador;Masculino;52;8;0;44
AREIAS;Vereador;Feminino;26;1;0;25
AREIÓPOLIS;Vereador;Masculino;61;9;0;52
AREIÓPOLIS;Vereador;Feminino;32;0;0;32
ARENÁPOLIS;Vereador;Masculino;33;8;0;25
ARENÁPOLIS;Vereador;Feminino;16;1;0;15
ARENÓPOLIS;Vereador;Masculino;24;9;0;15
ARENÓPOLIS;Vereador;Feminino;12;0;0;12
ARÊS;Vereador;Masculino;30;7;0;23
ARÊS;Vereador;Feminino;15;2;0;13
ARGIRITA;Vereador;Masculino;36;5;0;31
ARGIRITA;Vereador;Feminino;16;4;0;12
ARICANDUVA;Vereador;Masculino;24;8;0;16
ARICANDUVA;Vereador;Feminino;12;1;0;11
ARINOS;Vereador;Masculino;37;9;0;28
ARINOS;Vereador;Feminino;17;0;0;17
ARIPUANÃ;Vereador;Masculino;47;11;0;36
ARIPUANÃ;Vereador;Feminino;20;0;0;20
ARIQUEMES;Vereador;Masculino;111;12;0;99
ARIQUEMES;Vereador;Feminino;48;1;0;47
ARIRANHA;Vereador;Masculino;23;9;0;14
ARIRANHA;Vereador;Feminino;11;0;0;11
ARIRANHA DO IVAÍ;Vereador;Masculino;19;8;0;11
ARIRANHA DO IVAÍ;Vereador;Feminino;8;1;0;7
ARMAÇÃO DOS BÚZIOS;Vereador;Masculino;97;8;0;89
ARMAÇÃO DOS BÚZIOS;Vereador;Feminino;46;1;0;45
ARMAZÉM;Vereador;Masculino;24;8;0;16
ARMAZÉM;Vereador;Feminino;12;1;0;11
ARNEIROZ;Vereador;Masculino;22;8;0;14
ARNEIROZ;Vereador;Feminino;11;1;0;10
AROAZES;Vereador;Masculino;20;9;0;11
AROAZES;Vereador;Feminino;10;0;0;10
AROEIRAS;Vereador;Masculino;39;11;0;28
AROEIRAS;Vereador;Feminino;17;0;0;17
AROEIRAS DO ITAIM;Vereador;Masculino;20;8;0;12
AROEIRAS DO ITAIM;Vereador;Feminino;10;1;0;9
ARRAIAL;Vereador;Masculino;14;7;0;7
ARRAIAL;Vereador;Feminino;7;2;0;5
ARRAIAL DO CABO;Vereador;Masculino;81;8;0;73
ARRAIAL DO CABO;Vereador;Feminino;38;1;0;37
ARRAIAS;Vereador;Masculino;51;9;0;42
ARRAIAS;Vereador;Feminino;13;0;0;13
ARROIO DO MEIO;Vereador;Masculino;32;9;0;23
ARROIO DO MEIO;Vereador;Feminino;15;2;0;13
ARROIO DO PADRE;Vereador;Masculino;29;7;0;22
ARROIO DO PADRE;Vereador;Feminino;14;2;0;12
ARROIO DO SAL;Vereador;Masculino;46;7;0;39
ARROIO DO SAL;Vereador;Feminino;21;2;0;19
ARROIO DO TIGRE;Vereador;Masculino;19;8;0;11
ARROIO DO TIGRE;Vereador;Feminino;8;1;0;7
ARROIO DOS RATOS;Vereador;Masculino;35;5;0;30
ARROIO DOS RATOS;Vereador;Feminino;18;4;0;14
ARROIO GRANDE;Vereador;Masculino;33;9;0;24
ARROIO GRANDE;Vereador;Feminino;16;0;0;16
ARROIO TRINTA;Vereador;Masculino;15;7;0;8
ARROIO TRINTA;Vereador;Feminino;7;2;0;5
ARTUR NOGUEIRA;Vereador;Masculino;99;10;0;89
ARTUR NOGUEIRA;Vereador;Feminino;49;2;0;47
ARUANÃ;Vereador;Masculino;32;7;0;25
ARUANÃ;Vereador;Feminino;20;2;0;18
ARUJÁ;Vereador;Masculino;87;15;0;72
ARUJÁ;Vereador;Feminino;38;0;0;38
ARVOREDO;Vereador;Masculino;21;8;0;13
ARVOREDO;Vereador;Feminino;10;1;0;9
ARVOREZINHA;Vereador;Masculino;23;7;0;16
ARVOREZINHA;Vereador;Feminino;11;2;0;9
ASCURRA;Vereador;Masculino;24;8;0;16
ASCURRA;Vereador;Feminino;12;1;0;11
ASPÁSIA;Vereador;Masculino;20;8;0;12
ASPÁSIA;Vereador;Feminino;10;1;0;9
ASSAÍ;Vereador;Masculino;39;9;0;30
ASSAÍ;Vereador;Feminino;17;0;0;17
ASSARÉ;Vereador;Masculino;37;11;0;26
ASSARÉ;Vereador;Feminino;16;0;0;16
ASSIS;Vereador;Masculino;132;15;0;117
ASSIS;Vereador;Feminino;59;0;0;59
ASSIS BRASIL;Vereador;Masculino;31;6;0;25
ASSIS BRASIL;Vereador;Feminino;14;3;0;11
ASSIS CHATEAUBRIAND;Vereador;Masculino;72;11;0;61
ASSIS CHATEAUBRIAND;Vereador;Feminino;32;2;0;30
ASSÚ;Vereador;Masculino;93;14;0;79
ASSÚ;Vereador;Feminino;41;1;0;40
ASSUNÇÃO;Vereador;Masculino;20;8;0;12
ASSUNÇÃO;Vereador;Feminino;9;1;0;8
ASSUNÇÃO DO PIAUÍ;Vereador;Masculino;19;7;0;12
ASSUNÇÃO DO PIAUÍ;Vereador;Feminino;11;2;0;9
ASTOLFO DUTRA;Vereador;Masculino;57;8;0;49
ASTOLFO DUTRA;Vereador;Feminino;29;1;0;28
ASTORGA;Vereador;Masculino;65;9;0;56
ASTORGA;Vereador;Feminino;31;0;0;31
ATALAIA;Vereador;Masculino;89;18;0;71
ATALAIA;Vereador;Feminino;41;4;0;37
ATALAIA DO NORTE;Vereador;Masculino;47;10;0;37
ATALAIA DO NORTE;Vereador;Feminino;20;1;0;19
ATALANTA;Vereador;Masculino;20;9;0;11
ATALANTA;Vereador;Feminino;9;0;0;9
ATALÉIA;Vereador;Masculino;50;9;0;41
ATALÉIA;Vereador;Feminino;18;0;0;18
ATIBAIA;Vereador;Masculino;255;17;0;238
ATIBAIA;Vereador;Feminino;119;0;0;119
ATÍLIO VIVÁCQUA;Vereador;Masculino;58;8;0;50
ATÍLIO VIVÁCQUA;Vereador;Feminino;31;1;0;30
AUGUSTINÓPOLIS;Vereador;Masculino;42;9;0;33
AUGUSTINÓPOLIS;Vereador;Feminino;20;2;0;18
AUGUSTO CORRÊA;Vereador;Masculino;72;11;0;61
AUGUSTO CORRÊA;Vereador;Feminino;34;2;0;32
AUGUSTO DE LIMA;Vereador;Masculino;31;8;0;23
AUGUSTO DE LIMA;Vereador;Feminino;15;1;0;14
AUGUSTO PESTANA;Vereador;Masculino;18;7;0;11
AUGUSTO PESTANA;Vereador;Feminino;9;2;0;7
ÁUREA;Vereador;Masculino;19;9;0;10
ÁUREA;Vereador;Feminino;10;0;0;10
AURELINO LEAL;Vereador;Masculino;54;8;0;46
AURELINO LEAL;Vereador;Feminino;25;1;0;24
AURIFLAMA;Vereador;Masculino;41;7;0;34
AURIFLAMA;Vereador;Feminino;20;2;0;18
AURILÂNDIA;Vereador;Masculino;33;9;0;24
AURILÂNDIA;Vereador;Feminino;17;0;0;17
AURORA;Vereador;Masculino;48;18;0;30
AURORA;Vereador;Feminino;24;2;0;22
AURORA DO PARÁ;Vereador;Masculino;65;7;0;58
AURORA DO PARÁ;Vereador;Feminino;32;2;0;30
AURORA DO TOCANTINS;Vereador;Masculino;24;8;0;16
AURORA DO TOCANTINS;Vereador;Feminino;12;1;0;11
AUTAZES;Vereador;Masculino;101;11;0;90
AUTAZES;Vereador;Feminino;44;2;0;42
AVAÍ;Vereador;Masculino;26;8;0;18
AVAÍ;Vereador;Feminino;13;1;0;12
AVANHANDAVA;Vereador;Masculino;41;7;0;34
AVANHANDAVA;Vereador;Feminino;20;2;0;18
AVARÉ;Vereador;Masculino;148;11;0;137
AVARÉ;Vereador;Feminino;70;2;0;68
AVEIRO;Vereador;Masculino;53;8;0;45
AVEIRO;Vereador;Feminino;25;1;0;24
AVELINO LOPES;Vereador;Masculino;20;7;0;13
AVELINO LOPES;Vereador;Feminino;11;2;0;9
AVELINÓPOLIS;Vereador;Masculino;19;7;0;12
AVELINÓPOLIS;Vereador;Feminino;8;2;0;6
AXIXÁ;Vereador;Masculino;47;6;0;41
AXIXÁ;Vereador;Feminino;23;3;0;20
AXIXÁ DO TOCANTINS;Vereador;Masculino;36;7;0;29
AXIXÁ DO TOCANTINS;Vereador;Feminino;19;2;0;17
BABAÇULÂNDIA;Vereador;Masculino;25;9;0;16
BABAÇULÂNDIA;Vereador;Feminino;14;0;0;14
BACABAL;Vereador;Masculino;112;15;0;97
BACABAL;Vereador;Feminino;40;2;0;38
BACABEIRA;Vereador;Masculino;55;8;0;47
BACABEIRA;Vereador;Feminino;25;1;0;24
BACURI;Vereador;Masculino;45;10;0;35
BACURI;Vereador;Feminino;23;1;0;22
BACURITUBA;Vereador;Masculino;43;7;0;36
BACURITUBA;Vereador;Feminino;23;2;0;21
BADY BASSITT;Vereador;Masculino;45;7;0;38
BADY BASSITT;Vereador;Feminino;21;2;0;19
BAEPENDI;Vereador;Masculino;66;11;0;55
BAEPENDI;Vereador;Feminino;31;0;0;31
BAGÉ;Vereador;Masculino;139;13;0;126
BAGÉ;Vereador;Feminino;68;4;0;64
BAGRE;Vereador;Masculino;66;10;0;56
BAGRE;Vereador;Feminino;30;1;0;29
BAÍA DA TRAIÇÃO;Vereador;Masculino;44;8;0;36
BAÍA DA TRAIÇÃO;Vereador;Feminino;17;1;0;16
BAÍA FORMOSA;Vereador;Masculino;44;6;0;38
BAÍA FORMOSA;Vereador;Feminino;22;3;0;19
BAIANÓPOLIS;Vereador;Masculino;31;9;0;22
BAIANÓPOLIS;Vereador;Feminino;15;0;0;15
BAIÃO;Vereador;Masculino;45;12;0;33
BAIÃO;Vereador;Feminino;23;1;0;22
BAIXA GRANDE;Vereador;Masculino;30;8;0;22
BAIXA GRANDE;Vereador;Feminino;13;3;0;10
BAIXA GRANDE DO RIBEIRO;Vereador;Masculino;32;7;0;25
BAIXA GRANDE DO RIBEIRO;Vereador;Feminino;16;2;0;14
BAIXIO;Vereador;Masculino;21;5;0;16
BAIXIO;Vereador;Feminino;12;4;0;8
BAIXO GUANDU;Vereador;Masculino;85;11;0;74
BAIXO GUANDU;Vereador;Feminino;38;0;0;38
BALBINOS;Vereador;Masculino;18;8;0;10
BALBINOS;Vereador;Feminino;10;1;0;9
BALDIM;Vereador;Masculino;43;7;0;36
BALDIM;Vereador;Feminino;22;2;0;20
BALIZA;Vereador;Masculino;29;6;0;23
BALIZA;Vereador;Feminino;15;3;0;12
BALNEÁRIO ARROIO DO SILVA;Vereador;Masculino;31;8;0;23
BALNEÁRIO ARROIO DO SILVA;Vereador;Feminino;14;1;0;13
BALNEÁRIO BARRA DO SUL;Vereador;Masculino;59;9;0;50
BALNEÁRIO BARRA DO SUL;Vereador;Feminino;26;0;0;26
BALNEÁRIO CAMBORIÚ;Vereador;Masculino;96;12;0;84
BALNEÁRIO CAMBORIÚ;Vereador;Feminino;46;1;0;45
BALNEÁRIO GAIVOTA;Vereador;Masculino;24;7;0;17
BALNEÁRIO GAIVOTA;Vereador;Feminino;10;2;0;8
BALNEÁRIO PIÇARRAS;Vereador;Masculino;32;10;0;22
BALNEÁRIO PIÇARRAS;Vereador;Feminino;14;1;0;13
BALNEÁRIO PINHAL;Vereador;Masculino;46;7;0;39
BALNEÁRIO PINHAL;Vereador;Feminino;25;2;0;23
BALNEÁRIO RINCÃO;Vereador;Masculino;48;9;0;39
BALNEÁRIO RINCÃO;Vereador;Feminino;23;0;0;23
BALSA NOVA;Vereador;Masculino;65;9;0;56
BALSA NOVA;Vereador;Feminino;30;0;0;30
BÁLSAMO;Vereador;Masculino;33;7;0;26
BÁLSAMO;Vereador;Feminino;17;2;0;15
BALSAS;Vereador;Masculino;130;15;0;115
BALSAS;Vereador;Feminino;60;2;0;58
BAMBUÍ;Vereador;Masculino;75;9;0;66
BAMBUÍ;Vereador;Feminino;38;2;0;36
BANABUIÚ;Vereador;Masculino;41;7;0;34
BANABUIÚ;Vereador;Feminino;23;4;0;19
BANANAL;Vereador;Masculino;60;6;0;54
BANANAL;Vereador;Feminino;34;3;0;31
BANANEIRAS;Vereador;Masculino;30;9;0;21
BANANEIRAS;Vereador;Feminino;13;2;0;11
BANDEIRA;Vereador;Masculino;23;7;0;16
BANDEIRA;Vereador;Feminino;9;2;0;7
BANDEIRA DO SUL;Vereador;Masculino;54;8;0;46
BANDEIRA DO SUL;Vereador;Feminino;25;1;0;24
BANDEIRANTE;Vereador;Masculino;23;8;0;15
BANDEIRANTE;Vereador;Feminino;11;1;0;10
BANDEIRANTES;Vereador;Masculino;100;21;0;79
BANDEIRANTES;Vereador;Feminino;51;1;0;50
BANDEIRANTES DO TOCANTINS;Vereador;Masculino;18;8;0;10
BANDEIRANTES DO TOCANTINS;Vereador;Feminino;9;1;0;8
BANNACH;Vereador;Masculino;44;8;0;36
BANNACH;Vereador;Feminino;20;1;0;19
BANZAÊ;Vereador;Masculino;26;8;0;18
BANZAÊ;Vereador;Feminino;12;1;0;11
BARÃO;Vereador;Masculino;23;9;0;14
BARÃO;Vereador;Feminino;12;0;0;12
BARÃO DE ANTONINA;Vereador;Masculino;20;9;0;11
BARÃO DE ANTONINA;Vereador;Feminino;10;0;0;10
BARÃO DE COCAIS;Vereador;Masculino;96;10;0;86
BARÃO DE COCAIS;Vereador;Feminino;50;1;0;49
BARÃO DE COTEGIPE;Vereador;Masculino;27;6;0;21
BARÃO DE COTEGIPE;Vereador;Feminino;12;3;0;9
BARÃO DE GRAJAÚ;Vereador;Masculino;28;11;0;17
BARÃO DE GRAJAÚ;Vereador;Feminino;16;0;0;16
BARÃO DE MELGAÇO;Vereador;Masculino;27;8;0;19
BARÃO DE MELGAÇO;Vereador;Feminino;14;1;0;13
BARÃO DE MONTE ALTO;Vereador;Masculino;25;9;0;16
BARÃO DE MONTE ALTO;Vereador;Feminino;15;0;0;15
BARÃO DO TRIUNFO;Vereador;Masculino;36;8;0;28
BARÃO DO TRIUNFO;Vereador;Feminino;19;1;0;18
BARAÚNA;Vereador;Masculino;64;15;0;49
BARAÚNA;Vereador;Feminino;33;5;0;28
BARBACENA;Vereador;Masculino;154;12;0;142
BARBACENA;Vereador;Feminino;69;3;0;66
BARBALHA;Vereador;Masculino;90;14;0;76
BARBALHA;Vereador;Feminino;41;1;0;40
BARBOSA;Vereador;Masculino;36;7;0;29
BARBOSA;Vereador;Feminino;18;2;0;16
BARBOSA FERRAZ;Vereador;Masculino;23;9;0;14
BARBOSA FERRAZ;Vereador;Feminino;16;0;0;16
BARCARENA;Vereador;Masculino;152;11;0;141
BARCARENA;Vereador;Feminino;75;2;0;73
BARCELONA;Vereador;Masculino;16;9;0;7
BARCELONA;Vereador;Feminino;7;0;0;7
BARCELOS;Vereador;Masculino;61;10;0;51
BARCELOS;Vereador;Feminino;27;1;0;26
BARIRI;Vereador;Masculino;107;8;0;99
BARIRI;Vereador;Feminino;59;1;0;58
BARRA;Vereador;Masculino;45;13;0;32
BARRA;Vereador;Feminino;21;0;0;21
BARRA BONITA;Vereador;Masculino;154;20;0;134
BARRA BONITA;Vereador;Feminino;77;2;0;75
BARRA DA ESTIVA;Vereador;Masculino;28;10;0;18
BARRA DA ESTIVA;Vereador;Feminino;14;1;0;13
BARRA D'ALCÂNTARA;Vereador;Masculino;20;7;0;13
BARRA D'ALCÂNTARA;Vereador;Feminino;12;2;0;10
BARRA DE GUABIRABA;Vereador;Masculino;38;7;0;31
BARRA DE GUABIRABA;Vereador;Feminino;17;2;0;15
BARRA DE SANTA ROSA;Vereador;Masculino;19;8;0;11
BARRA DE SANTA ROSA;Vereador;Feminino;10;1;0;9
BARRA DE SANTANA;Vereador;Masculino;26;9;0;17
BARRA DE SANTANA;Vereador;Feminino;14;0;0;14
BARRA DE SANTO ANTÔNIO;Vereador;Masculino;58;5;0;53
BARRA DE SANTO ANTÔNIO;Vereador;Feminino;26;4;0;22
BARRA DE SÃO FRANCISCO;Vereador;Masculino;91;13;0;78
BARRA DE SÃO FRANCISCO;Vereador;Feminino;38;0;0;38
BARRA DE SÃO MIGUEL;Vereador;Masculino;59;15;0;44
BARRA DE SÃO MIGUEL;Vereador;Feminino;31;3;0;28
BARRA DO BUGRES;Vereador;Masculino;94;12;0;82
BARRA DO BUGRES;Vereador;Feminino;41;1;0;40
BARRA DO CHAPÉU;Vereador;Masculino;27;7;0;20
BARRA DO CHAPÉU;Vereador;Feminino;14;2;0;12
BARRA DO CHOÇA;Vereador;Masculino;52;10;0;42
BARRA DO CHOÇA;Vereador;Feminino;20;1;0;19
BARRA DO CORDA;Vereador;Masculino;94;12;0;82
BARRA DO CORDA;Vereador;Feminino;27;5;0;22
BARRA DO GARÇAS;Vereador;Masculino;89;14;0;75
BARRA DO GARÇAS;Vereador;Feminino;38;1;0;37
BARRA DO GUARITA;Vereador;Masculino;18;7;0;11
BARRA DO GUARITA;Vereador;Feminino;8;2;0;6
BARRA DO JACARÉ;Vereador;Masculino;44;9;0;35
BARRA DO JACARÉ;Vereador;Feminino;13;0;0;13
BARRA DO MENDES;Vereador;Masculino;27;7;0;20
BARRA DO MENDES;Vereador;Feminino;12;2;0;10
BARRA DO OURO;Vereador;Masculino;27;8;0;19
BARRA DO OURO;Vereador;Feminino;12;1;0;11
BARRA DO PIRAÍ;Vereador;Masculino;216;15;0;201
BARRA DO PIRAÍ;Vereador;Feminino;97;0;0;97
BARRA DO QUARAÍ;Vereador;Masculino;21;7;0;14
BARRA DO QUARAÍ;Vereador;Feminino;13;2;0;11
BARRA DO RIBEIRO;Vereador;Masculino;60;9;0;51
BARRA DO RIBEIRO;Vereador;Feminino;28;0;0;28
BARRA DO RIO AZUL;Vereador;Masculino;19;8;0;11
BARRA DO RIO AZUL;Vereador;Feminino;9;1;0;8
BARRA DO ROCHA;Vereador;Masculino;33;9;0;24
BARRA DO ROCHA;Vereador;Feminino;15;0;0;15
BARRA DO TURVO;Vereador;Masculino;36;7;0;29
BARRA DO TURVO;Vereador;Feminino;18;2;0;16
BARRA DOS COQUEIROS;Vereador;Masculino;66;10;0;56
BARRA DOS COQUEIROS;Vereador;Feminino;33;1;0;32
BARRA FUNDA;Vereador;Masculino;14;4;0;10
BARRA FUNDA;Vereador;Feminino;9;5;0;4
BARRA LONGA;Vereador;Masculino;27;9;0;18
BARRA LONGA;Vereador;Feminino;15;0;0;15
BARRA MANSA;Vereador;Masculino;232;19;0;213
BARRA MANSA;Vereador;Feminino;113;0;0;113
BARRA VELHA;Vereador;Masculino;30;9;0;21
BARRA VELHA;Vereador;Feminino;15;0;0;15
BARRACÃO;Vereador;Masculino;36;16;0;20
BARRACÃO;Vereador;Feminino;18;2;0;16
BARRAS;Vereador;Masculino;49;5;0;44
BARRAS;Vereador;Feminino;24;8;0;16
BARREIRA;Vereador;Masculino;38;11;0;27
BARREIRA;Vereador;Feminino;17;0;0;17
BARREIRAS;Vereador;Masculino;161;14;0;147
BARREIRAS;Vereador;Feminino;73;5;0;68
BARREIRAS DO PIAUÍ;Vereador;Masculino;11;7;0;4
BARREIRAS DO PIAUÍ;Vereador;Feminino;6;2;0;4
BARREIRINHA;Vereador;Masculino;57;9;0;48
BARREIRINHA;Vereador;Feminino;29;2;0;27
BARREIRINHAS;Vereador;Masculino;107;14;0;93
BARREIRINHAS;Vereador;Feminino;50;1;0;49
BARREIROS;Vereador;Masculino;78;13;0;65
BARREIROS;Vereador;Feminino;29;0;0;29
BARRETOS;Vereador;Masculino;132;15;0;117
BARRETOS;Vereador;Feminino;59;2;0;57
BARRINHA;Vereador;Masculino;118;10;0;108
BARRINHA;Vereador;Feminino;54;1;0;53
BARRO;Vereador;Masculino;24;9;0;15
BARRO;Vereador;Feminino;12;2;0;10
BARRO ALTO;Vereador;Masculino;54;16;0;38
BARRO ALTO;Vereador;Feminino;26;2;0;24
BARRO DURO;Vereador;Masculino;19;7;0;12
BARRO DURO;Vereador;Feminino;11;2;0;9
BARRO PRETO;Vereador;Masculino;59;9;0;50
BARRO PRETO;Vereador;Feminino;28;0;0;28
BARROCAS;Vereador;Masculino;33;9;0;24
BARROCAS;Vereador;Feminino;15;0;0;15
BARROLÂNDIA;Vereador;Masculino;22;8;0;14
BARROLÂNDIA;Vereador;Feminino;10;1;0;9
BARROQUINHA;Vereador;Masculino;18;7;0;11
BARROQUINHA;Vereador;Feminino;8;2;0;6
BARROS CASSAL;Vereador;Masculino;22;7;0;15
BARROS CASSAL;Vereador;Feminino;11;2;0;9
BARROSO;Vereador;Masculino;82;8;0;74
BARROSO;Vereador;Feminino;43;1;0;42
BARUERI;Vereador;Masculino;363;20;0;343
BARUERI;Vereador;Feminino;165;1;0;164
BASTOS;Vereador;Masculino;53;11;0;42
BASTOS;Vereador;Feminino;24;0;0;24
BATAGUASSU;Vereador;Masculino;54;8;0;46
BATAGUASSU;Vereador;Feminino;28;3;0;25
BATALHA;Vereador;Masculino;75;18;0;57
BATALHA;Vereador;Feminino;42;2;0;40
BATATAIS;Vereador;Masculino;95;12;0;83
BATATAIS;Vereador;Feminino;42;3;0;39
BATAYPORÃ;Vereador;Masculino;28;7;0;21
BATAYPORÃ;Vereador;Feminino;14;2;0;12
BATURITÉ;Vereador;Masculino;73;10;0;63
BATURITÉ;Vereador;Feminino;35;3;0;32
BAURU;Vereador;Masculino;173;16;0;157
BAURU;Vereador;Feminino;80;1;0;79
BAYEUX;Vereador;Masculino;207;13;0;194
BAYEUX;Vereador;Feminino;84;4;0;80
BEBEDOURO;Vereador;Masculino;119;10;0;109
BEBEDOURO;Vereador;Feminino;56;1;0;55
BEBERIBE;Vereador;Masculino;84;13;0;71
BEBERIBE;Vereador;Feminino;42;0;0;42
BELA CRUZ;Vereador;Masculino;41;12;0;29
BELA CRUZ;Vereador;Feminino;18;1;0;17
BELA VISTA;Vereador;Masculino;47;9;0;38
BELA VISTA;Vereador;Feminino;23;2;0;21
BELA VISTA DA CAROBA;Vereador;Masculino;18;8;0;10
BELA VISTA DA CAROBA;Vereador;Feminino;9;1;0;8
BELA VISTA DE GOIÁS;Vereador;Masculino;73;11;0;62
BELA VISTA DE GOIÁS;Vereador;Feminino;38;0;0;38
BELA VISTA DE MINAS;Vereador;Masculino;50;8;0;42
BELA VISTA DE MINAS;Vereador;Feminino;28;1;0;27
BELA VISTA DO MARANHÃO;Vereador;Masculino;25;9;0;16
BELA VISTA DO MARANHÃO;Vereador;Feminino;13;0;0;13
BELA VISTA DO PARAÍSO;Vereador;Masculino;62;8;0;54
BELA VISTA DO PARAÍSO;Vereador;Feminino;33;1;0;32
BELA VISTA DO PIAUÍ;Vereador;Masculino;11;9;0;2
BELA VISTA DO PIAUÍ;Vereador;Feminino;6;0;0;6
BELA VISTA DO TOLDO;Vereador;Masculino;40;7;0;33
BELA VISTA DO TOLDO;Vereador;Feminino;22;2;0;20
BELÁGUA;Vereador;Masculino;38;7;0;31
BELÁGUA;Vereador;Feminino;21;2;0;19
BELÉM;Vereador;Masculino;600;47;0;553
BELÉM;Vereador;Feminino;245;8;0;237
BELÉM DE MARIA;Vereador;Masculino;33;8;0;25
BELÉM DE MARIA;Vereador;Feminino;15;1;0;14
BELÉM DE SÃO FRANCISCO;Vereador;Masculino;39;10;0;29
BELÉM DE SÃO FRANCISCO;Vereador;Feminino;20;1;0;19
BELÉM DO BREJO DO CRUZ;Vereador;Masculino;19;8;0;11
BELÉM DO BREJO DO CRUZ;Vereador;Feminino;9;1;0;8
BELÉM DO PIAUÍ;Vereador;Masculino;19;8;0;11
BELÉM DO PIAUÍ;Vereador;Feminino;8;1;0;7
BELFORD ROXO;Vereador;Masculino;457;24;0;433
BELFORD ROXO;Vereador;Feminino;166;1;0;165
BELMIRO BRAGA;Vereador;Masculino;27;8;0;19
BELMIRO BRAGA;Vereador;Feminino;12;1;0;11
BELMONTE;Vereador;Masculino;72;18;0;54
BELMONTE;Vereador;Feminino;36;2;0;34
BELO CAMPO;Vereador;Masculino;34;10;0;24
BELO CAMPO;Vereador;Feminino;17;1;0;16
BELO HORIZONTE;Vereador;Masculino;841;40;0;801
BELO HORIZONTE;Vereador;Feminino;342;1;0;341
BELO JARDIM;Vereador;Masculino;51;10;0;41
BELO JARDIM;Vereador;Feminino;23;2;0;21
BELO MONTE;Vereador;Masculino;18;6;0;12
BELO MONTE;Vereador;Feminino;9;3;0;6
BELO ORIENTE;Vereador;Masculino;80;10;0;70
BELO ORIENTE;Vereador;Feminino;38;1;0;37
BELO VALE;Vereador;Masculino;31;8;0;23
BELO VALE;Vereador;Feminino;15;1;0;14
BELTERRA;Vereador;Masculino;60;9;0;51
BELTERRA;Vereador;Feminino;32;2;0;30
BENEDITINOS;Vereador;Masculino;31;8;0;23
BENEDITINOS;Vereador;Feminino;15;1;0;14
BENEDITO LEITE;Vereador;Masculino;20;9;0;11
BENEDITO LEITE;Vereador;Feminino;11;0;0;11
BENEDITO NOVO;Vereador;Masculino;26;8;0;18
BENEDITO NOVO;Vereador;Feminino;15;1;0;14
BENEVIDES;Vereador;Masculino;103;7;0;96
BENEVIDES;Vereador;Feminino;48;2;0;46
BENJAMIN CONSTANT;Vereador;Masculino;70;12;0;58
BENJAMIN CONSTANT;Vereador;Feminino;33;1;0;32
BENJAMIN CONSTANT DO SUL;Vereador;Masculino;12;9;0;3
BENJAMIN CONSTANT DO SUL;Vereador;Feminino;6;0;0;6
BENTO DE ABREU;Vereador;Masculino;22;7;0;15
BENTO DE ABREU;Vereador;Feminino;11;2;0;9
BENTO FERNANDES;Vereador;Masculino;22;7;0;15
BENTO FERNANDES;Vereador;Feminino;11;2;0;9
BENTO GONÇALVES;Vereador;Masculino;110;15;0;95
BENTO GONÇALVES;Vereador;Feminino;55;2;0;53
BEQUIMÃO;Vereador;Masculino;59;9;0;50
BEQUIMÃO;Vereador;Feminino;28;2;0;26
BERILO;Vereador;Masculino;39;9;0;30
BERILO;Vereador;Feminino;19;0;0;19
BERIZAL;Vereador;Masculino;24;8;0;16
BERIZAL;Vereador;Feminino;12;1;0;11
BERNARDINO BATISTA;Vereador;Masculino;21;6;0;15
BERNARDINO BATISTA;Vereador;Feminino;10;3;0;7
BERNARDINO DE CAMPOS;Vereador;Masculino;41;9;0;32
BERNARDINO DE CAMPOS;Vereador;Feminino;23;0;0;23
BERNARDO DO MEARIM;Vereador;Masculino;19;7;0;12
BERNARDO DO MEARIM;Vereador;Feminino;10;2;0;8
BERNARDO SAYÃO;Vereador;Masculino;29;6;0;23
BERNARDO SAYÃO;Vereador;Feminino;14;3;0;11
BERTIOGA;Vereador;Masculino;74;7;0;67
BERTIOGA;Vereador;Feminino;37;2;0;35
BERTOLÍNIA;Vereador;Masculino;20;6;0;14
BERTOLÍNIA;Vereador;Feminino;10;3;0;7
BERTÓPOLIS;Vereador;Masculino;29;9;0;20
BERTÓPOLIS;Vereador;Feminino;14;0;0;14
BERURI;Vereador;Masculino;35;7;0;28
BERURI;Vereador;Feminino;18;2;0;16
BETÂNIA;Vereador;Masculino;15;7;0;8
BETÂNIA;Vereador;Feminino;11;2;0;9
BETÂNIA DO PIAUÍ;Vereador;Masculino;14;8;0;6
BETÂNIA DO PIAUÍ;Vereador;Feminino;7;1;0;6
BETIM;Vereador;Masculino;322;21;0;301
BETIM;Vereador;Feminino;144;2;0;142
BEZERROS;Vereador;Masculino;79;11;0;68
BEZERROS;Vereador;Feminino;33;0;0;33
BIAS FORTES;Vereador;Masculino;22;8;0;14
BIAS FORTES;Vereador;Feminino;11;1;0;10
BICAS;Vereador;Masculino;64;7;0;57
BICAS;Vereador;Feminino;36;2;0;34
BIGUAÇU;Vereador;Masculino;101;13;0;88
BIGUAÇU;Vereador;Feminino;39;2;0;37
BILAC;Vereador;Masculino;19;7;0;12
BILAC;Vereador;Feminino;10;2;0;8
BIQUINHAS;Vereador;Masculino;16;9;0;7
BIQUINHAS;Vereador;Feminino;8;0;0;8
BIRIGUI;Vereador;Masculino;163;14;0;149
BIRIGUI;Vereador;Feminino;75;3;0;72
BIRITIBA MIRIM;Vereador;Masculino;97;10;0;87
BIRITIBA MIRIM;Vereador;Feminino;50;1;0;49
BIRITINGA;Vereador;Masculino;32;8;0;24
BIRITINGA;Vereador;Feminino;16;1;0;15
BITURUNA;Vereador;Masculino;48;9;0;39
BITURUNA;Vereador;Feminino;24;0;0;24
BLUMENAU;Vereador;Masculino;141;15;0;126
BLUMENAU;Vereador;Feminino;62;0;0;62
BOA ESPERANÇA;Vereador;Masculino;182;30;0;152
BOA ESPERANÇA;Vereador;Feminino;86;1;0;85
BOA ESPERANÇA DO IGUAÇU;Vereador;Masculino;12;9;0;3
BOA ESPERANÇA DO IGUAÇU;Vereador;Feminino;6;0;0;6
BOA ESPERANÇA DO SUL;Vereador;Masculino;36;8;0;28
BOA ESPERANÇA DO SUL;Vereador;Feminino;18;1;0;17
BOA HORA;Vereador;Masculino;24;7;0;17
BOA HORA;Vereador;Feminino;12;2;0;10
BOA NOVA;Vereador;Masculino;80;10;0;70
BOA NOVA;Vereador;Feminino;36;1;0;35
BOA SAÚDE;Vereador;Masculino;18;6;0;12
BOA SAÚDE;Vereador;Feminino;15;3;0;12
BOA VENTURA;Vereador;Masculino;24;9;0;15
BOA VENTURA;Vereador;Feminino;12;0;0;12
BOA VENTURA DE SÃO ROQUE;Vereador;Masculino;44;7;0;37
BOA VENTURA DE SÃO ROQUE;Vereador;Feminino;20;2;0;18
BOA VIAGEM;Vereador;Masculino;44;12;0;32
BOA VIAGEM;Vereador;Feminino;14;3;0;11
BOA VISTA;Vereador;Masculino;283;26;0;257
BOA VISTA;Vereador;Feminino;133;4;0;129
BOA VISTA DA APARECIDA;Vereador;Masculino;22;9;0;13
BOA VISTA DA APARECIDA;Vereador;Feminino;10;0;0;10
BOA VISTA DAS MISSÕES;Vereador;Masculino;12;7;0;5
BOA VISTA DAS MISSÕES;Vereador;Feminino;6;2;0;4
BOA VISTA DO BURICÁ;Vereador;Masculino;18;7;0;11
BOA VISTA DO BURICÁ;Vereador;Feminino;9;2;0;7
BOA VISTA DO CADEADO;Vereador;Masculino;18;9;0;9
BOA VISTA DO CADEADO;Vereador;Feminino;8;0;0;8
BOA VISTA DO GURUPI;Vereador;Masculino;40;6;0;34
BOA VISTA DO GURUPI;Vereador;Feminino;19;3;0;16
BOA VISTA DO INCRA;Vereador;Masculino;23;7;0;16
BOA VISTA DO INCRA;Vereador;Feminino;11;2;0;9
BOA VISTA DO RAMOS;Vereador;Masculino;68;8;0;60
BOA VISTA DO RAMOS;Vereador;Feminino;36;1;0;35
BOA VISTA DO SUL;Vereador;Masculino;13;7;0;6
BOA VISTA DO SUL;Vereador;Feminino;6;2;0;4
BOA VISTA DO TUPIM;Vereador;Masculino;29;9;0;20
BOA VISTA DO TUPIM;Vereador;Feminino;13;2;0;11
BOCA DA MATA;Vereador;Masculino;41;9;0;32
BOCA DA MATA;Vereador;Feminino;22;0;0;22
BOCA DO ACRE;Vereador;Masculino;52;8;0;44
BOCA DO ACRE;Vereador;Feminino;19;3;0;16
BOCAINA;Vereador;Masculino;92;16;0;76
BOCAINA;Vereador;Feminino;50;2;0;48
BOCAINA DE MINAS;Vereador;Masculino;37;8;0;29
BOCAINA DE MINAS;Vereador;Feminino;19;1;0;18
BOCAINA DO SUL;Vereador;Masculino;37;7;0;30
BOCAINA DO SUL;Vereador;Feminino;20;2;0;18
BOCAIÚVA;Vereador;Masculino;99;13;0;86
BOCAIÚVA;Vereador;Feminino;47;0;0;47
BOCAIÚVA DO SUL;Vereador;Masculino;59;9;0;50
BOCAIÚVA DO SUL;Vereador;Feminino;32;0;0;32
BODÓ;Vereador;Masculino;32;7;0;25
BODÓ;Vereador;Feminino;16;2;0;14
BODOCÓ;Vereador;Masculino;34;12;0;22
BODOCÓ;Vereador;Feminino;15;1;0;14
BODOQUENA;Vereador;Masculino;26;8;0;18
BODOQUENA;Vereador;Feminino;14;1;0;13
BOFETE;Vereador;Masculino;36;7;0;29
BOFETE;Vereador;Feminino;20;2;0;18
BOITUVA;Vereador;Masculino;101;13;0;88
BOITUVA;Vereador;Feminino;44;0;0;44
BOM CONSELHO;Vereador;Masculino;59;7;0;52
BOM CONSELHO;Vereador;Feminino;14;4;0;10
BOM DESPACHO;Vereador;Masculino;78;8;0;70
BOM DESPACHO;Vereador;Feminino;39;1;0;38
BOM JARDIM;Vereador;Masculino;166;29;0;137
BOM JARDIM;Vereador;Feminino;67;8;0;59
BOM JARDIM DA SERRA;Vereador;Masculino;20;7;0;13
BOM JARDIM DA SERRA;Vereador;Feminino;7;2;0;5
BOM JARDIM DE GOIÁS;Vereador;Masculino;26;9;0;17
BOM JARDIM DE GOIÁS;Vereador;Feminino;13;0;0;13
BOM JARDIM DE MINAS;Vereador;Masculino;23;8;0;15
BOM JARDIM DE MINAS;Vereador;Feminino;12;1;0;11
BOM JESUS;Vereador;Masculino;115;39;0;76
BOM JESUS;Vereador;Feminino;58;8;0;50
BOM JESUS DA LAPA;Vereador;Masculino;98;11;0;87
BOM JESUS DA LAPA;Vereador;Feminino;42;4;0;38
BOM JESUS DA PENHA;Vereador;Masculino;24;7;0;17
BOM JESUS DA PENHA;Vereador;Feminino;14;2;0;12
BOM JESUS DA SERRA;Vereador;Masculino;37;9;0;28
BOM JESUS DA SERRA;Vereador;Feminino;18;0;0;18
BOM JESUS DAS SELVAS;Vereador;Masculino;56;8;0;48
BOM JESUS DAS SELVAS;Vereador;Feminino;25;3;0;22
BOM JESUS DE GOIÁS;Vereador;Masculino;42;10;0;32
BOM JESUS DE GOIÁS;Vereador;Feminino;20;1;0;19
BOM JESUS DO AMPARO;Vereador;Masculino;34;6;0;28
BOM JESUS DO AMPARO;Vereador;Feminino;17;3;0;14
BOM JESUS DO ARAGUAIA;Vereador;Masculino;44;7;0;37
BOM JESUS DO ARAGUAIA;Vereador;Feminino;20;2;0;18
BOM JESUS DO GALHO;Vereador;Masculino;37;9;0;28
BOM JESUS DO GALHO;Vereador;Feminino;18;2;0;16
BOM JESUS DO ITABAPOANA;Vereador;Masculino;98;13;0;85
BOM JESUS DO ITABAPOANA;Vereador;Feminino;44;0;0;44
BOM JESUS DO NORTE;Vereador;Masculino;56;9;0;47
BOM JESUS DO NORTE;Vereador;Feminino;23;0;0;23
BOM JESUS DO OESTE;Vereador;Masculino;15;6;0;9
BOM JESUS DO OESTE;Vereador;Feminino;9;3;0;6
BOM JESUS DO SUL;Vereador;Masculino;15;9;0;6
BOM JESUS DO SUL;Vereador;Feminino;8;0;0;8
BOM JESUS DO TOCANTINS;Vereador;Masculino;77;15;0;62
BOM JESUS DO TOCANTINS;Vereador;Feminino;35;3;0;32
BOM JESUS DOS PERDÕES;Vereador;Masculino;78;9;0;69
BOM JESUS DOS PERDÕES;Vereador;Feminino;39;2;0;37
BOM LUGAR;Vereador;Masculino;32;9;0;23
BOM LUGAR;Vereador;Feminino;15;2;0;13
BOM PRINCÍPIO;Vereador;Masculino;25;9;0;16
BOM PRINCÍPIO;Vereador;Feminino;12;0;0;12
BOM PRINCÍPIO DO PIAUÍ;Vereador;Masculino;37;6;0;31
BOM PRINCÍPIO DO PIAUÍ;Vereador;Feminino;19;3;0;16
BOM PROGRESSO;Vereador;Masculino;21;9;0;12
BOM PROGRESSO;Vereador;Feminino;10;0;0;10
BOM REPOUSO;Vereador;Masculino;44;9;0;35
BOM REPOUSO;Vereador;Feminino;22;0;0;22
BOM RETIRO;Vereador;Masculino;27;8;0;19
BOM RETIRO;Vereador;Feminino;13;1;0;12
BOM RETIRO DO SUL;Vereador;Masculino;38;9;0;29
BOM RETIRO DO SUL;Vereador;Feminino;21;0;0;21
BOM SUCESSO;Vereador;Masculino;121;23;0;98
BOM SUCESSO;Vereador;Feminino;58;6;0;52
BOM SUCESSO DE ITARARÉ;Vereador;Masculino;28;8;0;20
BOM SUCESSO DE ITARARÉ;Vereador;Feminino;16;1;0;15
BOM SUCESSO DO SUL;Vereador;Masculino;12;9;0;3
BOM SUCESSO DO SUL;Vereador;Feminino;4;0;0;4
BOMBINHAS;Vereador;Masculino;66;6;0;60
BOMBINHAS;Vereador;Feminino;29;3;0;26
BONFIM;Vereador;Masculino;104;15;0;89
BONFIM;Vereador;Feminino;57;3;0;54
BONFIM DO PIAUÍ;Vereador;Masculino;23;8;0;15
BONFIM DO PIAUÍ;Vereador;Feminino;11;1;0;10
BONFINÓPOLIS;Vereador;Masculino;37;7;0;30
BONFINÓPOLIS;Vereador;Feminino;19;2;0;17
BONFINÓPOLIS DE MINAS;Vereador;Masculino;27;8;0;19
BONFINÓPOLIS DE MINAS;Vereador;Feminino;16;1;0;15
BONINAL;Vereador;Masculino;41;8;0;33
BONINAL;Vereador;Feminino;20;1;0;19
BONITO;Vereador;Masculino;205;37;0;168
BONITO;Vereador;Feminino;79;5;0;74
BONITO DE MINAS;Vereador;Masculino;45;9;0;36
BONITO DE MINAS;Vereador;Feminino;21;0;0;21
BONITO DE SANTA FÉ;Vereador;Masculino;22;9;0;13
BONITO DE SANTA FÉ;Vereador;Feminino;11;0;0;11
BONÓPOLIS;Vereador;Masculino;29;9;0;20
BONÓPOLIS;Vereador;Feminino;12;0;0;12
BOQUEIRÃO;Vereador;Masculino;53;10;0;43
BOQUEIRÃO;Vereador;Feminino;25;1;0;24
BOQUEIRÃO DO LEÃO;Vereador;Masculino;29;9;0;20
BOQUEIRÃO DO LEÃO;Vereador;Feminino;14;0;0;14
BOQUEIRÃO DO PIAUÍ;Vereador;Masculino;29;8;0;21
BOQUEIRÃO DO PIAUÍ;Vereador;Feminino;17;1;0;16
BOQUIM;Vereador;Masculino;56;9;0;47
BOQUIM;Vereador;Feminino;24;2;0;22
BOQUIRA;Vereador;Masculino;40;10;0;30
BOQUIRA;Vereador;Feminino;18;1;0;17
BORÁ;Vereador;Masculino;26;9;0;17
BORÁ;Vereador;Feminino;11;0;0;11
BORACÉIA;Vereador;Masculino;38;9;0;29
BORACÉIA;Vereador;Feminino;13;0;0;13
BORBA;Vereador;Masculino;52;7;0;45
BORBA;Vereador;Feminino;29;2;0;27
BORBOREMA;Vereador;Masculino;76;16;0;60
BORBOREMA;Vereador;Feminino;38;2;0;36
BORDA DA MATA;Vereador;Masculino;43;8;0;35
BORDA DA MATA;Vereador;Feminino;24;1;0;23
BOREBI;Vereador;Masculino;40;7;0;33
BOREBI;Vereador;Feminino;16;2;0;14
BORRAZÓPOLIS;Vereador;Masculino;31;8;0;23
BORRAZÓPOLIS;Vereador;Feminino;15;1;0;14
BOSSOROCA;Vereador;Masculino;18;6;0;12
BOSSOROCA;Vereador;Feminino;10;3;0;7
BOTELHOS;Vereador;Masculino;67;9;0;58
BOTELHOS;Vereador;Feminino;34;0;0;34
BOTUCATU;Vereador;Masculino;84;10;0;74
BOTUCATU;Vereador;Feminino;40;1;0;39
BOTUMIRIM;Vereador;Masculino;27;8;0;19
BOTUMIRIM;Vereador;Feminino;14;1;0;13
BOTUPORÃ;Vereador;Masculino;25;8;0;17
BOTUPORÃ;Vereador;Feminino;13;1;0;12
BOTUVERÁ;Vereador;Masculino;24;9;0;15
BOTUVERÁ;Vereador;Feminino;11;0;0;11
BOZANO;Vereador;Masculino;15;9;0;6
BOZANO;Vereador;Feminino;7;0;0;7
BRAÇO DO NORTE;Vereador;Masculino;44;7;0;37
BRAÇO DO NORTE;Vereador;Feminino;23;4;0;19
BRAÇO DO TROMBUDO;Vereador;Masculino;26;8;0;18
BRAÇO DO TROMBUDO;Vereador;Feminino;12;1;0;11
BRAGA;Vereador;Masculino;16;8;0;8
BRAGA;Vereador;Feminino;8;1;0;7
BRAGANÇA;Vereador;Masculino;131;13;0;118
BRAGANÇA;Vereador;Feminino;54;4;0;50
BRAGANÇA PAULISTA;Vereador;Masculino;265;16;0;249
BRAGANÇA PAULISTA;Vereador;Feminino;118;3;0;115
BRAGANEY;Vereador;Masculino;42;8;0;34
BRAGANEY;Vereador;Feminino;5;1;0;4
BRANQUINHA;Vereador;Masculino;35;7;0;28
BRANQUINHA;Vereador;Feminino;17;2;0;15
BRÁS PIRES;Vereador;Masculino;21;8;0;13
BRÁS PIRES;Vereador;Feminino;10;1;0;9
BRASIL NOVO;Vereador;Masculino;21;7;0;14
BRASIL NOVO;Vereador;Feminino;10;2;0;8
BRASILÂNDIA;Vereador;Masculino;34;8;0;26
BRASILÂNDIA;Vereador;Feminino;16;1;0;15
BRASILÂNDIA DE MINAS;Vereador;Masculino;43;8;0;35
BRASILÂNDIA DE MINAS;Vereador;Feminino;23;1;0;22
BRASILÂNDIA DO SUL;Vereador;Masculino;21;8;0;13
BRASILÂNDIA DO SUL;Vereador;Feminino;10;1;0;9
BRASILÂNDIA DO TOCANTINS;Vereador;Masculino;18;7;0;11
BRASILÂNDIA DO TOCANTINS;Vereador;Feminino;9;2;0;7
BRASILÉIA;Vereador;Masculino;86;8;0;78
BRASILÉIA;Vereador;Feminino;45;3;0;42
BRASILEIRA;Vereador;Masculino;21;7;0;14
BRASILEIRA;Vereador;Feminino;11;2;0;9
BRASÍLIA DE MINAS;Vereador;Masculino;67;9;0;58
BRASÍLIA DE MINAS;Vereador;Feminino;26;4;0;22
BRASNORTE;Vereador;Masculino;41;7;0;34
BRASNORTE;Vereador;Feminino;20;2;0;18
BRAÚNA;Vereador;Masculino;33;9;0;24
BRAÚNA;Vereador;Feminino;18;0;0;18
BRAÚNAS;Vereador;Masculino;37;8;0;29
BRAÚNAS;Vereador;Feminino;17;1;0;16
BRAZABRANTES;Vereador;Masculino;31;9;0;22
BRAZABRANTES;Vereador;Feminino;17;0;0;17
BRAZÓPOLIS;Vereador;Masculino;52;9;0;43
BRAZÓPOLIS;Vereador;Feminino;31;0;0;31
BREJÃO;Vereador;Masculino;26;9;0;17
BREJÃO;Vereador;Feminino;14;0;0;14
BREJETUBA;Vereador;Masculino;40;7;0;33
BREJETUBA;Vereador;Feminino;22;2;0;20
BREJINHO;Vereador;Masculino;39;14;0;25
BREJINHO;Vereador;Feminino;20;4;0;16
BREJINHO DE NAZARÉ;Vereador;Masculino;19;6;0;13
BREJINHO DE NAZARÉ;Vereador;Feminino;9;3;0;6
BREJO;Vereador;Masculino;70;6;0;64
BREJO;Vereador;Feminino;43;7;0;36
BREJO ALEGRE;Vereador;Masculino;31;8;0;23
BREJO ALEGRE;Vereador;Feminino;13;1;0;12
BREJO DA MADRE DE DEUS;Vereador;Masculino;30;10;0;20
BREJO DA MADRE DE DEUS;Vereador;Feminino;14;1;0;13
BREJO DE AREIA;Vereador;Masculino;15;7;0;8
BREJO DE AREIA;Vereador;Feminino;8;2;0;6
BREJO DO CRUZ;Vereador;Masculino;24;9;0;15
BREJO DO CRUZ;Vereador;Feminino;12;0;0;12
BREJO DO PIAUÍ;Vereador;Masculino;16;8;0;8
BREJO DO PIAUÍ;Vereador;Feminino;6;1;0;5
BREJO DOS SANTOS;Vereador;Masculino;16;8;0;8
BREJO DOS SANTOS;Vereador;Feminino;7;1;0;6
BREJO GRANDE;Vereador;Masculino;36;9;0;27
BREJO GRANDE;Vereador;Feminino;16;0;0;16
BREJO GRANDE DO ARAGUAIA;Vereador;Masculino;28;8;0;20
BREJO GRANDE DO ARAGUAIA;Vereador;Feminino;12;1;0;11
BREJO SANTO;Vereador;Masculino;24;11;0;13
BREJO SANTO;Vereador;Feminino;11;2;0;9
BREJÕES;Vereador;Masculino;52;8;0;44
BREJÕES;Vereador;Feminino;25;1;0;24
BREJOLÂNDIA;Vereador;Masculino;19;8;0;11
BREJOLÂNDIA;Vereador;Feminino;9;1;0;8
BREU BRANCO;Vereador;Masculino;62;7;0;55
BREU BRANCO;Vereador;Feminino;30;6;0;24
BREVES;Vereador;Masculino;120;13;0;107
BREVES;Vereador;Feminino;57;2;0;55
BRITÂNIA;Vereador;Masculino;38;8;0;30
BRITÂNIA;Vereador;Feminino;16;1;0;15
BROCHIER;Vereador;Masculino;33;9;0;24
BROCHIER;Vereador;Feminino;16;0;0;16
BRODOWSKI;Vereador;Masculino;77;11;0;66
BRODOWSKI;Vereador;Feminino;38;0;0;38
BROTAS;Vereador;Masculino;85;10;0;75
BROTAS;Vereador;Feminino;41;1;0;40
BROTAS DE MACAÚBAS;Vereador;Masculino;24;8;0;16
BROTAS DE MACAÚBAS;Vereador;Feminino;12;1;0;11
BRUMADINHO;Vereador;Masculino;121;11;0;110
BRUMADINHO;Vereador;Feminino;54;2;0;52
BRUMADO;Vereador;Masculino;61;12;0;49
BRUMADO;Vereador;Feminino;28;1;0;27
BRUNÓPOLIS;Vereador;Masculino;23;9;0;14
BRUNÓPOLIS;Vereador;Feminino;11;0;0;11
BRUSQUE;Vereador;Masculino;109;14;0;95
BRUSQUE;Vereador;Feminino;52;1;0;51
BUENO BRANDÃO;Vereador;Masculino;36;6;0;30
BUENO BRANDÃO;Vereador;Feminino;19;3;0;16
BUENÓPOLIS;Vereador;Masculino;56;9;0;47
BUENÓPOLIS;Vereador;Feminino;29;0;0;29
BUENOS AIRES;Vereador;Masculino;45;8;0;37
BUENOS AIRES;Vereador;Feminino;22;1;0;21
BUERAREMA;Vereador;Masculino;73;11;0;62
BUERAREMA;Vereador;Feminino;27;0;0;27
BUGRE;Vereador;Masculino;31;8;0;23
BUGRE;Vereador;Feminino;11;1;0;10
BUÍQUE;Vereador;Masculino;70;13;0;57
BUÍQUE;Vereador;Feminino;29;0;0;29
BUJARI;Vereador;Masculino;40;9;0;31
BUJARI;Vereador;Feminino;23;0;0;23
BUJARU;Vereador;Masculino;69;9;0;60
BUJARU;Vereador;Feminino;35;2;0;33
BURI;Vereador;Masculino;72;10;0;62
BURI;Vereador;Feminino;34;1;0;33
BURITAMA;Vereador;Masculino;49;9;0;40
BURITAMA;Vereador;Feminino;24;2;0;22
BURITI;Vereador;Masculino;61;8;0;53
BURITI;Vereador;Feminino;33;3;0;30
BURITI ALEGRE;Vereador;Masculino;35;9;0;26
BURITI ALEGRE;Vereador;Feminino;16;0;0;16
BURITI BRAVO;Vereador;Masculino;46;8;0;38
BURITI BRAVO;Vereador;Feminino;22;3;0;19
BURITI DE GOIÁS;Vereador;Masculino;25;9;0;16
BURITI DE GOIÁS;Vereador;Feminino;9;0;0;9
BURITI DO TOCANTINS;Vereador;Masculino;21;6;0;15
BURITI DO TOCANTINS;Vereador;Feminino;9;3;0;6
BURITI DOS LOPES;Vereador;Masculino;35;6;0;29
BURITI DOS LOPES;Vereador;Feminino;16;5;0;11
BURITI DOS MONTES;Vereador;Masculino;15;8;0;7
BURITI DOS MONTES;Vereador;Feminino;8;1;0;7
BURITICUPU;Vereador;Masculino;42;12;0;30
BURITICUPU;Vereador;Feminino;18;3;0;15
BURITINÓPOLIS;Vereador;Masculino;32;9;0;23
BURITINÓPOLIS;Vereador;Feminino;15;0;0;15
BURITIRAMA;Vereador;Masculino;26;10;0;16
BURITIRAMA;Vereador;Feminino;12;1;0;11
BURITIRANA;Vereador;Masculino;31;7;0;24
BURITIRANA;Vereador;Feminino;17;2;0;15
BURITIS;Vereador;Masculino;131;18;0;113
BURITIS;Vereador;Feminino;62;2;0;60
BURITIZAL;Vereador;Masculino;35;6;0;29
BURITIZAL;Vereador;Feminino;17;3;0;14
BURITIZEIRO;Vereador;Masculino;104;10;0;94
BURITIZEIRO;Vereador;Feminino;52;1;0;51
BUTIÁ;Vereador;Masculino;60;8;0;52
BUTIÁ;Vereador;Feminino;34;1;0;33
CAAPIRANGA;Vereador;Masculino;57;9;0;48
CAAPIRANGA;Vereador;Feminino;31;0;0;31
CAAPORÃ;Vereador;Masculino;59;9;0;50
CAAPORÃ;Vereador;Feminino;34;2;0;32
CAARAPÓ;Vereador;Masculino;32;10;0;22
CAARAPÓ;Vereador;Feminino;17;1;0;16
CAATIBA;Vereador;Masculino;34;8;0;26
CAATIBA;Vereador;Feminino;16;1;0;15
CABACEIRAS;Vereador;Masculino;22;9;0;13
CABACEIRAS;Vereador;Feminino;11;0;0;11
CABACEIRAS DO PARAGUAÇU;Vereador;Masculino;31;9;0;22
CABACEIRAS DO PARAGUAÇU;Vereador;Feminino;16;2;0;14
CABECEIRA GRANDE;Vereador;Masculino;51;6;0;45
CABECEIRA GRANDE;Vereador;Feminino;28;3;0;25
CABECEIRAS;Vereador;Masculino;29;9;0;20
CABECEIRAS;Vereador;Feminino;13;0;0;13
CABECEIRAS DO PIAUÍ;Vereador;Masculino;32;7;0;25
CABECEIRAS DO PIAUÍ;Vereador;Feminino;15;2;0;13
CABEDELO;Vereador;Masculino;127;13;0;114
CABEDELO;Vereador;Feminino;50;2;0;48
CABIXI;Vereador;Masculino;34;8;0;26
CABIXI;Vereador;Feminino;7;1;0;6
CABO DE SANTO AGOSTINHO;Vereador;Masculino;189;17;0;172
CABO DE SANTO AGOSTINHO;Vereador;Feminino;74;0;0;74
CABO FRIO;Vereador;Masculino;236;17;0;219
CABO FRIO;Vereador;Feminino;107;0;0;107
CABO VERDE;Vereador;Masculino;37;9;0;28
CABO VERDE;Vereador;Feminino;19;0;0;19
CABRÁLIA PAULISTA;Vereador;Masculino;59;8;0;51
CABRÁLIA PAULISTA;Vereador;Feminino;35;1;0;34
CABREÚVA;Vereador;Masculino;112;6;0;106
CABREÚVA;Vereador;Feminino;54;3;0;51
CABROBÓ;Vereador;Masculino;55;11;0;44
CABROBÓ;Vereador;Feminino;24;1;0;23
CAÇADOR;Vereador;Masculino;76;11;0;65
CAÇADOR;Vereador;Feminino;35;2;0;33
CAÇAPAVA;Vereador;Masculino;113;9;0;104
CAÇAPAVA;Vereador;Feminino;50;1;0;49
CAÇAPAVA DO SUL;Vereador;Masculino;37;8;0;29
CAÇAPAVA DO SUL;Vereador;Feminino;21;3;0;18
CACAULÂNDIA;Vereador;Masculino;29;6;0;23
CACAULÂNDIA;Vereador;Feminino;17;3;0;14
CACEQUI;Vereador;Masculino;33;7;0;26
CACEQUI;Vereador;Feminino;17;2;0;15
CÁCERES;Vereador;Masculino;94;10;0;84
CÁCERES;Vereador;Feminino;43;1;0;42
CACHOEIRA;Vereador;Masculino;74;9;0;65
CACHOEIRA;Vereador;Feminino;34;4;0;30
CACHOEIRA ALTA;Vereador;Masculino;34;9;0;25
CACHOEIRA ALTA;Vereador;Feminino;18;0;0;18
CACHOEIRA DA PRATA;Vereador;Masculino;38;8;0;30
CACHOEIRA DA PRATA;Vereador;Feminino;21;1;0;20
CACHOEIRA DE GOIÁS;Vereador;Masculino;21;9;0;12
CACHOEIRA DE GOIÁS;Vereador;Feminino;10;0;0;10
CACHOEIRA DE MINAS;Vereador;Masculino;38;8;0;30
CACHOEIRA DE MINAS;Vereador;Feminino;23;1;0;22
CACHOEIRA DE PAJEÚ;Vereador;Masculino;41;7;0;34
CACHOEIRA DE PAJEÚ;Vereador;Feminino;21;2;0;19
CACHOEIRA DO ARARI;Vereador;Masculino;58;8;0;50
CACHOEIRA DO ARARI;Vereador;Feminino;32;3;0;29
CACHOEIRA DO PIRIÁ;Vereador;Masculino;51;9;0;42
CACHOEIRA DO PIRIÁ;Vereador;Feminino;25;2;0;23
CACHOEIRA DO SUL;Vereador;Masculino;94;14;0;80
CACHOEIRA DO SUL;Vereador;Feminino;35;1;0;34
CACHOEIRA DOS ÍNDIOS;Vereador;Masculino;14;8;0;6
CACHOEIRA DOS ÍNDIOS;Vereador;Feminino;7;1;0;6
CACHOEIRA DOURADA;Vereador;Masculino;60;16;0;44
CACHOEIRA DOURADA;Vereador;Feminino;32;2;0;30
CACHOEIRA GRANDE;Vereador;Masculino;43;7;0;36
CACHOEIRA GRANDE;Vereador;Feminino;23;2;0;21
CACHOEIRA PAULISTA;Vereador;Masculino;114;11;0;103
CACHOEIRA PAULISTA;Vereador;Feminino;49;2;0;47
CACHOEIRAS DE MACACU;Vereador;Masculino;117;12;0;105
CACHOEIRAS DE MACACU;Vereador;Feminino;51;1;0;50
CACHOEIRINHA;Vereador;Masculino;197;31;0;166
CACHOEIRINHA;Vereador;Feminino;95;6;0;89
CACHOEIRO DE ITAPEMIRIM;Vereador;Masculino;216;19;0;197
CACHOEIRO DE ITAPEMIRIM;Vereador;Feminino;96;0;0;96
CACIMBA DE AREIA;Vereador;Masculino;19;8;0;11
CACIMBA DE AREIA;Vereador;Feminino;8;1;0;7
CACIMBA DE DENTRO;Vereador;Masculino;29;9;0;20
CACIMBA DE DENTRO;Vereador;Feminino;14;2;0;12
CACIMBAS;Vereador;Masculino;22;9;0;13
CACIMBAS;Vereador;Feminino;6;0;0;6
CACIMBINHAS;Vereador;Masculino;24;7;0;17
CACIMBINHAS;Vereador;Feminino;9;2;0;7
CACIQUE DOBLE;Vereador;Masculino;18;9;0;9
CACIQUE DOBLE;Vereador;Feminino;8;0;0;8
CACOAL;Vereador;Masculino;58;11;0;47
CACOAL;Vereador;Feminino;27;1;0;26
CACONDE;Vereador;Masculino;70;9;0;61
CACONDE;Vereador;Feminino;35;0;0;35
CAÇU;Vereador;Masculino;30;6;0;24
CAÇU;Vereador;Feminino;14;3;0;11
CACULÉ;Vereador;Masculino;30;10;0;20
CACULÉ;Vereador;Feminino;14;1;0;13
CAEM;Vereador;Masculino;16;6;0;10
CAEM;Vereador;Feminino;10;3;0;7
CAETANÓPOLIS;Vereador;Masculino;52;9;0;43
CAETANÓPOLIS;Vereador;Feminino;26;0;0;26
CAETANOS;Vereador;Masculino;41;8;0;33
CAETANOS;Vereador;Feminino;18;1;0;17
CAETÉ;Vereador;Masculino;137;13;0;124
CAETÉ;Vereador;Feminino;61;0;0;61
CAETÉS;Vereador;Masculino;28;9;0;19
CAETÉS;Vereador;Feminino;4;2;0;2
CAETITÉ;Vereador;Masculino;37;12;0;25
CAETITÉ;Vereador;Feminino;16;1;0;15
CAFARNAUM;Vereador;Masculino;43;9;0;34
CAFARNAUM;Vereador;Feminino;13;2;0;11
CAFEARA;Vereador;Masculino;21;9;0;12
CAFEARA;Vereador;Feminino;1;0;0;1
CAFELÂNDIA;Vereador;Masculino;106;19;0;87
CAFELÂNDIA;Vereador;Feminino;43;1;0;42
CAFEZAL DO SUL;Vereador;Masculino;21;7;0;14
CAFEZAL DO SUL;Vereador;Feminino;10;2;0;8
CAIABU;Vereador;Masculino;57;8;0;49
CAIABU;Vereador;Feminino;32;1;0;31
CAIANA;Vereador;Masculino;24;8;0;16
CAIANA;Vereador;Feminino;14;1;0;13
CAIAPÔNIA;Vereador;Masculino;44;11;0;33
CAIAPÔNIA;Vereador;Feminino;21;0;0;21
CAIBATÉ;Vereador;Masculino;19;7;0;12
CAIBATÉ;Vereador;Feminino;9;2;0;7
CAIBI;Vereador;Masculino;12;8;0;4
CAIBI;Vereador;Feminino;6;1;0;5
CAIÇARA;Vereador;Masculino;32;14;0;18
CAIÇARA;Vereador;Feminino;19;4;0;15
CAIÇARA DO NORTE;Vereador;Masculino;23;6;0;17
CAIÇARA DO NORTE;Vereador;Feminino;9;3;0;6
CAIÇARA DO RIO DO VENTO;Vereador;Masculino;31;7;0;24
CAIÇARA DO RIO DO VENTO;Vereador;Feminino;15;2;0;13
CAICÓ;Vereador;Masculino;99;14;0;85
CAICÓ;Vereador;Feminino;43;1;0;42
CAIEIRAS;Vereador;Masculino;143;7;0;136
CAIEIRAS;Vereador;Feminino;66;3;0;63
CAIRU;Vereador;Masculino;42;11;0;31
CAIRU;Vereador;Feminino;19;0;0;19
CAIUÁ;Vereador;Masculino;45;8;0;37
CAIUÁ;Vereador;Feminino;23;1;0;22
CAJAMAR;Vereador;Masculino;146;13;0;133
CAJAMAR;Vereador;Feminino;65;2;0;63
CAJAPIÓ;Vereador;Masculino;48;9;0;39
CAJAPIÓ;Vereador;Feminino;24;2;0;22
CAJARI;Vereador;Masculino;56;10;0;46
CAJARI;Vereador;Feminino;28;1;0;27
CAJATI;Vereador;Masculino;58;8;0;50
CAJATI;Vereador;Feminino;30;1;0;29
CAJAZEIRAS;Vereador;Masculino;73;14;0;59
CAJAZEIRAS;Vereador;Feminino;34;1;0;33
CAJAZEIRAS DO PIAUÍ;Vereador;Masculino;17;9;0;8
CAJAZEIRAS DO PIAUÍ;Vereador;Feminino;9;0;0;9
CAJAZEIRINHAS;Vereador;Masculino;14;8;0;6
CAJAZEIRINHAS;Vereador;Feminino;7;1;0;6
CAJOBI;Vereador;Masculino;47;8;0;39
CAJOBI;Vereador;Feminino;22;1;0;21
CAJUEIRO;Vereador;Masculino;41;9;0;32
CAJUEIRO;Vereador;Feminino;16;2;0;14
CAJUEIRO DA PRAIA;Vereador;Masculino;26;7;0;19
CAJUEIRO DA PRAIA;Vereador;Feminino;15;2;0;13
CAJURI;Vereador;Masculino;22;5;0;17
CAJURI;Vereador;Feminino;12;4;0;8
CAJURU;Vereador;Masculino;57;9;0;48
CAJURU;Vereador;Feminino;27;0;0;27
CALÇADO;Vereador;Masculino;26;9;0;17
CALÇADO;Vereador;Feminino;13;0;0;13
CALÇOENE;Vereador;Masculino;40;8;0;32
CALÇOENE;Vereador;Feminino;15;1;0;14
CALDAS;Vereador;Masculino;37;6;0;31
CALDAS;Vereador;Feminino;17;3;0;14
CALDAS BRANDÃO;Vereador;Masculino;25;6;0;19
CALDAS BRANDÃO;Vereador;Feminino;14;3;0;11
CALDAS NOVAS;Vereador;Masculino;109;14;0;95
CALDAS NOVAS;Vereador;Feminino;45;1;0;44
CALDAZINHA;Vereador;Masculino;50;9;0;41
CALDAZINHA;Vereador;Feminino;25;0;0;25
CALDEIRÃO GRANDE;Vereador;Masculino;41;7;0;34
CALDEIRÃO GRANDE;Vereador;Feminino;22;2;0;20
CALDEIRÃO GRANDE DO PIAUÍ;Vereador;Masculino;18;6;0;12
CALDEIRÃO GRANDE DO PIAUÍ;Vereador;Feminino;9;3;0;6
CALIFÓRNIA;Vereador;Masculino;53;6;0;47
CALIFÓRNIA;Vereador;Feminino;25;3;0;22
CALMON;Vereador;Masculino;27;7;0;20
CALMON;Vereador;Feminino;14;2;0;12
CALUMBI;Vereador;Masculino;10;5;0;5
CALUMBI;Vereador;Feminino;8;4;0;4
CAMACÃ;Vereador;Masculino;74;10;0;64
CAMACÃ;Vereador;Feminino;31;3;0;28
CAMAÇARI;Vereador;Masculino;208;18;0;190
CAMAÇARI;Vereador;Feminino;93;1;0;92
CAMACHO;Vereador;Masculino;21;7;0;14
CAMACHO;Vereador;Feminino;12;2;0;10
CAMALAÚ;Vereador;Masculino;16;8;0;8
CAMALAÚ;Vereador;Feminino;6;1;0;5
CAMAMU;Vereador;Masculino;67;12;0;55
CAMAMU;Vereador;Feminino;32;1;0;31
CAMANDUCAIA;Vereador;Masculino;78;9;0;69
CAMANDUCAIA;Vereador;Feminino;38;2;0;36
CAMAPUÃ;Vereador;Masculino;47;8;0;39
CAMAPUÃ;Vereador;Feminino;32;1;0;31
CAMAQUÃ;Vereador;Masculino;90;14;0;76
CAMAQUÃ;Vereador;Feminino;42;1;0;41
CAMARAGIBE;Vereador;Masculino;170;13;0;157
CAMARAGIBE;Vereador;Feminino;47;0;0;47
CAMARGO;Vereador;Masculino;17;8;0;9
CAMARGO;Vereador;Feminino;8;1;0;7
CAMBARÁ;Vereador;Masculino;55;9;0;46
CAMBARÁ;Vereador;Feminino;27;0;0;27
CAMBARÁ DO SUL;Vereador;Masculino;35;8;0;27
CAMBARÁ DO SUL;Vereador;Feminino;16;1;0;15
CAMBÉ;Vereador;Masculino;76;9;0;67
CAMBÉ;Vereador;Feminino;34;1;0;33
CAMBIRA;Vereador;Masculino;39;8;0;31
CAMBIRA;Vereador;Feminino;20;1;0;19
CAMBORIÚ;Vereador;Masculino;103;12;0;91
CAMBORIÚ;Vereador;Feminino;47;3;0;44
CAMBUCI;Vereador;Masculino;72;8;0;64
CAMBUCI;Vereador;Feminino;30;1;0;29
CAMBUÍ;Vereador;Masculino;61;7;0;54
CAMBUÍ;Vereador;Feminino;32;2;0;30
CAMBUQUIRA;Vereador;Masculino;50;8;0;42
CAMBUQUIRA;Vereador;Feminino;27;1;0;26
CAMETÁ;Vereador;Masculino;117;15;0;102
CAMETÁ;Vereador;Feminino;46;0;0;46
CAMOCIM;Vereador;Masculino;94;13;0;81
CAMOCIM;Vereador;Feminino;43;2;0;41
CAMOCIM DE SÃO FÉLIX;Vereador;Masculino;30;6;0;24
CAMOCIM DE SÃO FÉLIX;Vereador;Feminino;6;5;0;1
CAMPANÁRIO;Vereador;Masculino;29;9;0;20
CAMPANÁRIO;Vereador;Feminino;14;0;0;14
CAMPANHA;Vereador;Masculino;53;8;0;45
CAMPANHA;Vereador;Feminino;27;3;0;24
CAMPESTRE;Vereador;Masculino;85;16;0;69
CAMPESTRE;Vereador;Feminino;42;4;0;38
CAMPESTRE DA SERRA;Vereador;Masculino;20;7;0;13
CAMPESTRE DA SERRA;Vereador;Feminino;11;2;0;9
CAMPESTRE DE GOIÁS;Vereador;Masculino;35;7;0;28
CAMPESTRE DE GOIÁS;Vereador;Feminino;16;2;0;14
CAMPESTRE DO MARANHÃO;Vereador;Masculino;51;8;0;43
CAMPESTRE DO MARANHÃO;Vereador;Feminino;26;1;0;25
CAMPINA DA LAGOA;Vereador;Masculino;37;8;0;29
CAMPINA DA LAGOA;Vereador;Feminino;19;1;0;18
CAMPINA DAS MISSÕES;Vereador;Masculino;15;9;0;6
CAMPINA DAS MISSÕES;Vereador;Feminino;7;0;0;7
CAMPINA DO MONTE ALEGRE;Vereador;Masculino;39;8;0;31
CAMPINA DO MONTE ALEGRE;Vereador;Feminino;21;1;0;20
CAMPINA DO SIMÃO;Vereador;Masculino;33;9;0;24
CAMPINA DO SIMÃO;Vereador;Feminino;10;0;0;10
CAMPINA GRANDE;Vereador;Masculino;256;23;0;233
CAMPINA GRANDE;Vereador;Feminino;103;0;0;103
CAMPINA GRANDE DO SUL;Vereador;Masculino;83;9;0;74
CAMPINA GRANDE DO SUL;Vereador;Feminino;43;0;0;43
CAMPINA VERDE;Vereador;Masculino;41;9;0;32
CAMPINA VERDE;Vereador;Feminino;21;2;0;19
CAMPINAÇU;Vereador;Masculino;23;8;0;15
CAMPINAÇU;Vereador;Feminino;7;1;0;6
CAMPINÁPOLIS;Vereador;Masculino;33;8;0;25
CAMPINÁPOLIS;Vereador;Feminino;15;1;0;14
CAMPINAS;Vereador;Masculino;486;32;0;454
CAMPINAS;Vereador;Feminino;215;1;0;214
CAMPINAS DO PIAUÍ;Vereador;Masculino;23;9;0;14
CAMPINAS DO PIAUÍ;Vereador;Feminino;12;0;0;12
CAMPINAS DO SUL;Vereador;Masculino;19;8;0;11
CAMPINAS DO SUL;Vereador;Feminino;9;1;0;8
CAMPINORTE;Vereador;Masculino;36;9;0;27
CAMPINORTE;Vereador;Feminino;18;0;0;18
CAMPO ALEGRE;Vereador;Masculino;123;19;0;104
CAMPO ALEGRE;Vereador;Feminino;58;5;0;53
CAMPO ALEGRE DE GOIÁS;Vereador;Masculino;29;8;0;21
CAMPO ALEGRE DE GOIÁS;Vereador;Feminino;13;1;0;12
CAMPO ALEGRE DE LOURDES;Vereador;Masculino;44;8;0;36
CAMPO ALEGRE DE LOURDES;Vereador;Feminino;25;3;0;22
CAMPO ALEGRE DO FIDALGO;Vereador;Masculino;17;6;0;11
CAMPO ALEGRE DO FIDALGO;Vereador;Feminino;9;3;0;6
CAMPO AZUL;Vereador;Masculino;23;9;0;14
CAMPO AZUL;Vereador;Feminino;11;0;0;11
CAMPO BELO;Vereador;Masculino;109;12;0;97
CAMPO BELO;Vereador;Feminino;44;3;0;41
CAMPO BELO DO SUL;Vereador;Masculino;23;8;0;15
CAMPO BELO DO SUL;Vereador;Feminino;12;1;0;11
CAMPO BOM;Vereador;Masculino;74;11;0;63
CAMPO BOM;Vereador;Feminino;35;0;0;35
CAMPO BONITO;Vereador;Masculino;28;9;0;19
CAMPO BONITO;Vereador;Feminino;6;0;0;6
CAMPO DO BRITO;Vereador;Masculino;35;10;0;25
CAMPO DO BRITO;Vereador;Feminino;16;1;0;15
CAMPO DO MEIO;Vereador;Masculino;58;7;0;51
CAMPO DO MEIO;Vereador;Feminino;27;2;0;25
CAMPO DO TENENTE;Vereador;Masculino;45;8;0;37
CAMPO DO TENENTE;Vereador;Feminino;25;1;0;24
CAMPO ERÊ;Vereador;Masculino;23;8;0;15
CAMPO ERÊ;Vereador;Feminino;12;1;0;11
CAMPO FLORIDO;Vereador;Masculino;27;6;0;21
CAMPO FLORIDO;Vereador;Feminino;17;3;0;14
CAMPO FORMOSO;Vereador;Masculino;60;15;0;45
CAMPO FORMOSO;Vereador;Feminino;27;0;0;27
CAMPO GRANDE;Vereador;Masculino;377;37;0;340
CAMPO GRANDE;Vereador;Feminino;176;10;0;166
CAMPO GRANDE DO PIAUÍ;Vereador;Masculino;16;8;0;8
CAMPO GRANDE DO PIAUÍ;Vereador;Feminino;6;1;0;5
CAMPO LARGO;Vereador;Masculino;121;7;0;114
CAMPO LARGO;Vereador;Feminino;55;4;0;51
CAMPO LARGO DO PIAUÍ;Vereador;Masculino;24;7;0;17
CAMPO LARGO DO PIAUÍ;Vereador;Feminino;13;2;0;11
CAMPO LIMPO DE GOIÁS;Vereador;Masculino;37;8;0;29
CAMPO LIMPO DE GOIÁS;Vereador;Feminino;18;1;0;17
CAMPO LIMPO PAULISTA;Vereador;Masculino;125;9;0;116
CAMPO LIMPO PAULISTA;Vereador;Feminino;54;1;0;53
CAMPO MAGRO;Vereador;Masculino;111;10;0;101
CAMPO MAGRO;Vereador;Feminino;48;1;0;47
CAMPO MAIOR;Vereador;Masculino;62;12;0;50
CAMPO MAIOR;Vereador;Feminino;28;1;0;27
CAMPO MOURÃO;Vereador;Masculino;107;10;0;97
CAMPO MOURÃO;Vereador;Feminino;54;3;0;51
CAMPO NOVO;Vereador;Masculino;32;9;0;23
CAMPO NOVO;Vereador;Feminino;15;0;0;15
CAMPO NOVO DE RONDÔNIA;Vereador;Masculino;31;5;0;26
CAMPO NOVO DE RONDÔNIA;Vereador;Feminino;12;4;0;8
CAMPO NOVO DO PARECIS;Vereador;Masculino;45;9;0;36
CAMPO NOVO DO PARECIS;Vereador;Feminino;20;0;0;20
CAMPO REDONDO;Vereador;Masculino;24;7;0;17
CAMPO REDONDO;Vereador;Feminino;15;2;0;13
CAMPO VERDE;Vereador;Masculino;91;11;0;80
CAMPO VERDE;Vereador;Feminino;43;2;0;41
CAMPOS ALTOS;Vereador;Masculino;36;7;0;29
CAMPOS ALTOS;Vereador;Feminino;19;2;0;17
CAMPOS BELOS;Vereador;Masculino;45;11;0;34
CAMPOS BELOS;Vereador;Feminino;24;0;0;24
CAMPOS BORGES;Vereador;Masculino;20;8;0;12
CAMPOS BORGES;Vereador;Feminino;11;1;0;10
CAMPOS DE JÚLIO;Vereador;Masculino;18;6;0;12
CAMPOS DE JÚLIO;Vereador;Feminino;13;3;0;10
CAMPOS DO JORDÃO;Vereador;Masculino;134;13;0;121
CAMPOS DO JORDÃO;Vereador;Feminino;60;0;0;60
CAMPOS DOS GOYTACAZES;Vereador;Masculino;439;22;0;417
CAMPOS DOS GOYTACAZES;Vereador;Feminino;192;3;0;189
CAMPOS GERAIS;Vereador;Masculino;69;9;0;60
CAMPOS GERAIS;Vereador;Feminino;31;2;0;29
CAMPOS LINDOS;Vereador;Masculino;31;8;0;23
CAMPOS LINDOS;Vereador;Feminino;13;1;0;12
CAMPOS NOVOS;Vereador;Masculino;33;9;0;24
CAMPOS NOVOS;Vereador;Feminino;17;0;0;17
CAMPOS NOVOS PAULISTA;Vereador;Masculino;39;8;0;31
CAMPOS NOVOS PAULISTA;Vereador;Feminino;20;1;0;19
CAMPOS SALES;Vereador;Masculino;29;8;0;21
CAMPOS SALES;Vereador;Feminino;13;3;0;10
CAMPOS VERDES;Vereador;Masculino;32;8;0;24
CAMPOS VERDES;Vereador;Feminino;13;1;0;12
CAMUTANGA;Vereador;Masculino;21;7;0;14
CAMUTANGA;Vereador;Feminino;7;2;0;5
CANA VERDE;Vereador;Masculino;50;9;0;41
CANA VERDE;Vereador;Feminino;25;0;0;25
CANAÃ;Vereador;Masculino;28;8;0;20
CANAÃ;Vereador;Feminino;14;1;0;13
CANAÃ DOS CARAJÁS;Vereador;Masculino;78;11;0;67
CANAÃ DOS CARAJÁS;Vereador;Feminino;35;0;0;35
CANABRAVA DO NORTE;Vereador;Masculino;27;8;0;19
CANABRAVA DO NORTE;Vereador;Feminino;14;1;0;13
CANANÉIA;Vereador;Masculino;69;9;0;60
CANANÉIA;Vereador;Feminino;36;0;0;36
CANAPI;Vereador;Masculino;37;9;0;28
CANAPI;Vereador;Feminino;22;0;0;22
CANÁPOLIS;Vereador;Masculino;86;15;0;71
CANÁPOLIS;Vereador;Feminino;42;3;0;39
CANARANA;Vereador;Masculino;72;17;0;55
CANARANA;Vereador;Feminino;34;3;0;31
CANAS;Vereador;Masculino;50;9;0;41
CANAS;Vereador;Feminino;29;0;0;29
CANAVIEIRA;Vereador;Masculino;24;8;0;16
CANAVIEIRA;Vereador;Feminino;11;1;0;10
CANAVIEIRAS;Vereador;Masculino;61;7;0;54
CANAVIEIRAS;Vereador;Feminino;29;2;0;27
CANDEAL;Vereador;Masculino;31;8;0;23
CANDEAL;Vereador;Feminino;14;1;0;13
CANDEIAS;Vereador;Masculino;215;21;0;194
CANDEIAS;Vereador;Feminino;108;5;0;103
CANDEIAS DO JAMARI;Vereador;Masculino;114;9;0;105
CANDEIAS DO JAMARI;Vereador;Feminino;56;0;0;56
CANDELÁRIA;Vereador;Masculino;50;11;0;39
CANDELÁRIA;Vereador;Feminino;24;2;0;22
CANDIBA;Vereador;Masculino;23;8;0;15
CANDIBA;Vereador;Feminino;12;1;0;11
CÂNDIDO DE ABREU;Vereador;Masculino;43;11;0;32
CÂNDIDO DE ABREU;Vereador;Feminino;20;0;0;20
CÂNDIDO GODÓI;Vereador;Masculino;15;7;0;8
CÂNDIDO GODÓI;Vereador;Feminino;7;2;0;5
CÂNDIDO MENDES;Vereador;Masculino;88;8;0;80
CÂNDIDO MENDES;Vereador;Feminino;42;3;0;39
CÂNDIDO MOTA;Vereador;Masculino;54;7;0;47
CÂNDIDO MOTA;Vereador;Feminino;27;2;0;25
CÂNDIDO RODRIGUES;Vereador;Masculino;37;8;0;29
CÂNDIDO RODRIGUES;Vereador;Feminino;18;1;0;17
CÂNDIDO SALES;Vereador;Masculino;51;10;0;41
CÂNDIDO SALES;Vereador;Feminino;21;1;0;20
CANDIOTA;Vereador;Masculino;44;7;0;37
CANDIOTA;Vereador;Feminino;23;2;0;21
CANDÓI;Vereador;Masculino;53;8;0;45
CANDÓI;Vereador;Feminino;19;1;0;18
CANELA;Vereador;Masculino;49;10;0;39
CANELA;Vereador;Feminino;25;1;0;24
CANELINHA;Vereador;Masculino;21;7;0;14
CANELINHA;Vereador;Feminino;10;2;0;8
CANGUARETAMA;Vereador;Masculino;71;12;0;59
CANGUARETAMA;Vereador;Feminino;32;1;0;31
CANGUÇU;Vereador;Masculino;96;15;0;81
CANGUÇU;Vereador;Feminino;41;0;0;41
CANHOBA;Vereador;Masculino;26;8;0;18
CANHOBA;Vereador;Feminino;12;1;0;11
CANHOTINHO;Vereador;Masculino;43;9;0;34
CANHOTINHO;Vereador;Feminino;20;2;0;18
CANINDÉ;Vereador;Masculino;109;12;0;97
CANINDÉ;Vereador;Feminino;49;3;0;46
CANINDÉ DE SÃO FRANCISCO;Vereador;Masculino;42;10;0;32
CANINDÉ DE SÃO FRANCISCO;Vereador;Feminino;20;1;0;19
CANITAR;Vereador;Masculino;31;8;0;23
CANITAR;Vereador;Feminino;15;1;0;14
CANOAS;Vereador;Masculino;226;21;0;205
CANOAS;Vereador;Feminino;112;0;0;112
CANOINHAS;Vereador;Masculino;63;9;0;54
CANOINHAS;Vereador;Feminino;26;1;0;25
CANSANÇÃO;Vereador;Masculino;74;12;0;62
CANSANÇÃO;Vereador;Feminino;26;1;0;25
CANTÁ;Vereador;Masculino;75;7;0;68
CANTÁ;Vereador;Feminino;40;2;0;38
CANTAGALO;Vereador;Masculino;150;25;0;125
CANTAGALO;Vereador;Feminino;73;4;0;69
CANTANHEDE;Vereador;Masculino;54;9;0;45
CANTANHEDE;Vereador;Feminino;26;2;0;24
CANTO DO BURITI;Vereador;Masculino;38;10;0;28
CANTO DO BURITI;Vereador;Feminino;17;1;0;16
CANUDOS;Vereador;Masculino;26;11;0;15
CANUDOS;Vereador;Feminino;12;0;0;12
CANUDOS DO VALE;Vereador;Masculino;18;8;0;10
CANUDOS DO VALE;Vereador;Feminino;11;1;0;10
CANUTAMA;Vereador;Masculino;36;7;0;29
CANUTAMA;Vereador;Feminino;13;2;0;11
CAPANEMA;Vereador;Masculino;127;20;0;107
CAPANEMA;Vereador;Feminino;60;4;0;56
CAPÃO ALTO;Vereador;Masculino;24;7;0;17
CAPÃO ALTO;Vereador;Feminino;13;2;0;11
CAPÃO BONITO;Vereador;Masculino;95;13;0;82
CAPÃO BONITO;Vereador;Feminino;41;0;0;41
CAPÃO BONITO DO SUL;Vereador;Masculino;27;8;0;19
CAPÃO BONITO DO SUL;Vereador;Feminino;13;1;0;12
CAPÃO DA CANOA;Vereador;Masculino;73;10;0;63
CAPÃO DA CANOA;Vereador;Feminino;37;1;0;36
CAPÃO DO CIPÓ;Vereador;Masculino;18;7;0;11
CAPÃO DO CIPÓ;Vereador;Feminino;8;2;0;6
CAPÃO DO LEÃO;Vereador;Masculino;67;9;0;58
CAPÃO DO LEÃO;Vereador;Feminino;37;2;0;35
CAPARAÓ;Vereador;Masculino;41;8;0;33
CAPARAÓ;Vereador;Feminino;19;1;0;18
CAPELA;Vereador;Masculino;101;20;0;81
CAPELA;Vereador;Feminino;46;4;0;42
CAPELA DE SANTANA;Vereador;Masculino;57;8;0;49
CAPELA DE SANTANA;Vereador;Feminino;29;1;0;28
CAPELA DO ALTO;Vereador;Masculino;96;9;0;87
CAPELA DO ALTO;Vereador;Feminino;47;2;0;45
CAPELA DO ALTO ALEGRE;Vereador;Masculino;31;8;0;23
CAPELA DO ALTO ALEGRE;Vereador;Feminino;16;1;0;15
CAPELA NOVA;Vereador;Masculino;24;8;0;16
CAPELA NOVA;Vereador;Feminino;12;1;0;11
CAPELINHA;Vereador;Masculino;52;12;0;40
CAPELINHA;Vereador;Feminino;24;1;0;23
CAPETINGA;Vereador;Masculino;41;6;0;35
CAPETINGA;Vereador;Feminino;24;3;0;21
CAPIM;Vereador;Masculino;38;7;0;31
CAPIM;Vereador;Feminino;20;2;0;18
CAPIM BRANCO;Vereador;Masculino;62;8;0;54
CAPIM BRANCO;Vereador;Feminino;30;1;0;29
CAPIM GROSSO;Vereador;Masculino;51;10;0;41
CAPIM GROSSO;Vereador;Feminino;14;1;0;13
CAPINÓPOLIS;Vereador;Masculino;55;11;0;44
CAPINÓPOLIS;Vereador;Feminino;31;0;0;31
CAPINZAL;Vereador;Masculino;23;8;0;15
CAPINZAL;Vereador;Feminino;10;1;0;9
CAPINZAL DO NORTE;Vereador;Masculino;30;7;0;23
CAPINZAL DO NORTE;Vereador;Feminino;13;2;0;11
CAPISTRANO;Vereador;Masculino;53;10;0;43
CAPISTRANO;Vereador;Feminino;26;1;0;25
CAPITÃO;Vereador;Masculino;21;8;0;13
CAPITÃO;Vereador;Feminino;10;1;0;9
CAPITÃO ANDRADE;Vereador;Masculino;32;8;0;24
CAPITÃO ANDRADE;Vereador;Feminino;17;1;0;16
CAPITÃO DE CAMPOS;Vereador;Masculino;22;8;0;14
CAPITÃO DE CAMPOS;Vereador;Feminino;11;1;0;10
CAPITÃO ENÉAS;Vereador;Masculino;58;7;0;51
CAPITÃO ENÉAS;Vereador;Feminino;30;2;0;28
CAPITÃO GERVÁSIO OLIVEIRA;Vereador;Masculino;20;8;0;12
CAPITÃO GERVÁSIO OLIVEIRA;Vereador;Feminino;10;1;0;9
CAPITÃO LEÔNIDAS MARQUES;Vereador;Masculino;33;9;0;24
CAPITÃO LEÔNIDAS MARQUES;Vereador;Feminino;15;0;0;15
CAPITÃO POÇO;Vereador;Masculino;59;12;0;47
CAPITÃO POÇO;Vereador;Feminino;28;3;0;25
CAPITÓLIO;Vereador;Masculino;24;8;0;16
CAPITÓLIO;Vereador;Feminino;12;1;0;11
CAPIVARI;Vereador;Masculino;82;12;0;70
CAPIVARI;Vereador;Feminino;34;1;0;33
CAPIVARI DE BAIXO;Vereador;Masculino;72;11;0;61
CAPIVARI DE BAIXO;Vereador;Feminino;30;0;0;30
CAPIVARI DO SUL;Vereador;Masculino;22;7;0;15
CAPIVARI DO SUL;Vereador;Feminino;12;2;0;10
CAPIXABA;Vereador;Masculino;60;8;0;52
CAPIXABA;Vereador;Feminino;25;1;0;24
CAPOEIRAS;Vereador;Masculino;47;10;0;37
CAPOEIRAS;Vereador;Feminino;4;1;0;3
CAPUTIRA;Vereador;Masculino;25;8;0;17
CAPUTIRA;Vereador;Feminino;12;1;0;11
CARAÁ;Vereador;Masculino;23;9;0;14
CARAÁ;Vereador;Feminino;11;0;0;11
CARACARAÍ;Vereador;Masculino;72;11;0;61
CARACARAÍ;Vereador;Feminino;36;0;0;36
CARACOL;Vereador;Masculino;43;14;0;29
CARACOL;Vereador;Feminino;22;4;0;18
CARAGUATATUBA;Vereador;Masculino;160;14;0;146
CARAGUATATUBA;Vereador;Feminino;70;1;0;69
CARAÍ;Vereador;Masculino;42;7;0;35
CARAÍ;Vereador;Feminino;17;2;0;15
CARAÍBAS;Vereador;Masculino;33;8;0;25
CARAÍBAS;Vereador;Feminino;17;1;0;16
CARAMBEÍ;Vereador;Masculino;69;9;0;60
CARAMBEÍ;Vereador;Feminino;32;2;0;30
CARANAÍBA;Vereador;Masculino;28;9;0;19
CARANAÍBA;Vereador;Feminino;13;0;0;13
CARANDAÍ;Vereador;Masculino;70;9;0;61
CARANDAÍ;Vereador;Feminino;34;2;0;32
CARANGOLA;Vereador;Masculino;102;12;0;90
CARANGOLA;Vereador;Feminino;51;1;0;50
CARAPEBUS;Vereador;Masculino;48;8;0;40
CARAPEBUS;Vereador;Feminino;22;1;0;21
CARAPICUÍBA;Vereador;Masculino;253;15;0;238
CARAPICUÍBA;Vereador;Feminino;119;2;0;117
CARATINGA;Vereador;Masculino;175;14;0;161
CARATINGA;Vereador;Feminino;83;3;0;80
CARAUARI;Vereador;Masculino;40;8;0;32
CARAUARI;Vereador;Feminino;19;3;0;16
CARAÚBAS;Vereador;Masculino;46;18;0;28
CARAÚBAS;Vereador;Feminino;22;2;0;20
CARAÚBAS DO PIAUÍ;Vereador;Masculino;13;6;0;7
CARAÚBAS DO PIAUÍ;Vereador;Feminino;7;3;0;4
CARAVELAS;Vereador;Masculino;52;9;0;43
CARAVELAS;Vereador;Feminino;24;2;0;22
CARAZINHO;Vereador;Masculino;73;13;0;60
CARAZINHO;Vereador;Feminino;32;0;0;32
CARBONITA;Vereador;Masculino;28;8;0;20
CARBONITA;Vereador;Feminino;13;1;0;12
CARDEAL DA SILVA;Vereador;Masculino;38;6;0;32
CARDEAL DA SILVA;Vereador;Feminino;21;3;0;18
CARDOSO;Vereador;Masculino;34;8;0;26
CARDOSO;Vereador;Feminino;18;1;0;17
CARDOSO MOREIRA;Vereador;Masculino;54;8;0;46
CARDOSO MOREIRA;Vereador;Feminino;26;1;0;25
CAREAÇU;Vereador;Masculino;29;9;0;20
CAREAÇU;Vereador;Feminino;18;0;0;18
CAREIRO;Vereador;Masculino;106;12;0;94
CAREIRO;Vereador;Feminino;42;1;0;41
CAREIRO DA VÁRZEA;Vereador;Masculino;90;8;0;82
CAREIRO DA VÁRZEA;Vereador;Feminino;41;3;0;38
CARIACICA;Vereador;Masculino;248;17;0;231
CARIACICA;Vereador;Feminino;100;2;0;98
CARIDADE;Vereador;Masculino;39;10;0;29
CARIDADE;Vereador;Feminino;19;1;0;18
CARIDADE DO PIAUÍ;Vereador;Masculino;16;7;0;9
CARIDADE DO PIAUÍ;Vereador;Feminino;7;2;0;5
CARINHANHA;Vereador;Masculino;69;9;0;60
CARINHANHA;Vereador;Feminino;33;2;0;31
CARIRA;Vereador;Masculino;39;9;0;30
CARIRA;Vereador;Feminino;14;2;0;12
CARIRÉ;Vereador;Masculino;22;10;0;12
CARIRÉ;Vereador;Feminino;10;1;0;9
CARIRI DO TOCANTINS;Vereador;Masculino;23;8;0;15
CARIRI DO TOCANTINS;Vereador;Feminino;12;1;0;11
CARIRIAÇU;Vereador;Masculino;49;10;0;39
CARIRIAÇU;Vereador;Feminino;24;1;0;23
CARIÚS;Vereador;Masculino;29;7;0;22
CARIÚS;Vereador;Feminino;15;4;0;11
CARLINDA;Vereador;Masculino;37;7;0;30
CARLINDA;Vereador;Feminino;18;2;0;16
CARLÓPOLIS;Vereador;Masculino;57;7;0;50
CARLÓPOLIS;Vereador;Feminino;26;2;0;24
CARLOS BARBOSA;Vereador;Masculino;42;10;0;32
CARLOS BARBOSA;Vereador;Feminino;20;1;0;19
CARLOS CHAGAS;Vereador;Masculino;55;8;0;47
CARLOS CHAGAS;Vereador;Feminino;25;1;0;24
CARLOS GOMES;Vereador;Masculino;16;7;0;9
CARLOS GOMES;Vereador;Feminino;8;2;0;6
CARMÉSIA;Vereador;Masculino;28;8;0;20
CARMÉSIA;Vereador;Feminino;13;1;0;12
CARMO;Vereador;Masculino;60;10;0;50
CARMO;Vereador;Feminino;32;1;0;31
CARMO DA CACHOEIRA;Vereador;Masculino;78;7;0;71
CARMO DA CACHOEIRA;Vereador;Feminino;40;2;0;38
CARMO DA MATA;Vereador;Masculino;65;8;0;57
CARMO DA MATA;Vereador;Feminino;29;1;0;28
CARMO DE MINAS;Vereador;Masculino;61;7;0;54
CARMO DE MINAS;Vereador;Feminino;30;2;0;28
CARMO DO CAJURU;Vereador;Masculino;68;11;0;57
CARMO DO CAJURU;Vereador;Feminino;31;0;0;31
CARMO DO PARANAÍBA;Vereador;Masculino;44;10;0;34
CARMO DO PARANAÍBA;Vereador;Feminino;17;1;0;16
CARMO DO RIO CLARO;Vereador;Masculino;65;9;0;56
CARMO DO RIO CLARO;Vereador;Feminino;32;0;0;32
CARMO DO RIO VERDE;Vereador;Masculino;61;9;0;52
CARMO DO RIO VERDE;Vereador;Feminino;25;0;0;25
CARMOLÂNDIA;Vereador;Masculino;37;8;0;29
CARMOLÂNDIA;Vereador;Feminino;15;1;0;14
CARMÓPOLIS;Vereador;Masculino;38;9;0;29
CARMÓPOLIS;Vereador;Feminino;18;0;0;18
CARMÓPOLIS DE MINAS;Vereador;Masculino;40;10;0;30
CARMÓPOLIS DE MINAS;Vereador;Feminino;18;1;0;17
CARNAÍBA;Vereador;Masculino;23;10;0;13
CARNAÍBA;Vereador;Feminino;9;1;0;8
CARNAÚBA DOS DANTAS;Vereador;Masculino;19;5;0;14
CARNAÚBA DOS DANTAS;Vereador;Feminino;9;4;0;5
CARNAUBAIS;Vereador;Masculino;26;7;0;19
CARNAUBAIS;Vereador;Feminino;12;2;0;10
CARNAUBAL;Vereador;Masculino;14;9;0;5
CARNAUBAL;Vereador;Feminino;7;2;0;5
CARNAUBEIRA DA PENHA;Vereador;Masculino;58;8;0;50
CARNAUBEIRA DA PENHA;Vereador;Feminino;24;1;0;23
CARNEIRINHO;Vereador;Masculino;41;9;0;32
CARNEIRINHO;Vereador;Feminino;22;0;0;22
CARNEIROS;Vereador;Masculino;34;7;0;27
CARNEIROS;Vereador;Feminino;16;2;0;14
CAROEBE;Vereador;Masculino;39;6;0;33
CAROEBE;Vereador;Feminino;21;3;0;18
CAROLINA;Vereador;Masculino;37;10;0;27
CAROLINA;Vereador;Feminino;17;1;0;16
CARPINA;Vereador;Masculino;116;13;0;103
CARPINA;Vereador;Feminino;35;2;0;33
CARRANCAS;Vereador;Masculino;32;8;0;24
CARRANCAS;Vereador;Feminino;23;1;0;22
CARRAPATEIRA;Vereador;Masculino;11;8;0;3
CARRAPATEIRA;Vereador;Feminino;9;1;0;8
CARRASCO BONITO;Vereador;Masculino;24;8;0;16
CARRASCO BONITO;Vereador;Feminino;12;1;0;11
CARUARU;Vereador;Masculino;205;23;0;182
CARUARU;Vereador;Feminino;86;0;0;86
CARUTAPERA;Vereador;Masculino;27;9;0;18
CARUTAPERA;Vereador;Feminino;13;0;0;13
CARVALHÓPOLIS;Vereador;Masculino;33;7;0;26
CARVALHÓPOLIS;Vereador;Feminino;16;2;0;14
CARVALHOS;Vereador;Masculino;24;8;0;16
CARVALHOS;Vereador;Feminino;12;1;0;11
CASA BRANCA;Vereador;Masculino;81;10;0;71
CASA BRANCA;Vereador;Feminino;43;1;0;42
CASA GRANDE;Vereador;Masculino;13;7;0;6
CASA GRANDE;Vereador;Feminino;6;2;0;4
CASA NOVA;Vereador;Masculino;87;12;0;75
CASA NOVA;Vereador;Feminino;43;1;0;42
CASCA;Vereador;Masculino;20;5;0;15
CASCA;Vereador;Feminino;16;4;0;12
CASCALHO RICO;Vereador;Masculino;28;7;0;21
CASCALHO RICO;Vereador;Feminino;15;2;0;13
CASCAVEL;Vereador;Masculino;330;30;0;300
CASCAVEL;Vereador;Feminino;147;1;0;146
CASEARA;Vereador;Masculino;45;8;0;37
CASEARA;Vereador;Feminino;27;1;0;26
CASEIROS;Vereador;Masculino;21;9;0;12
CASEIROS;Vereador;Feminino;9;0;0;9
CASIMIRO DE ABREU;Vereador;Masculino;119;9;0;110
CASIMIRO DE ABREU;Vereador;Feminino;60;0;0;60
CASINHAS;Vereador;Masculino;17;5;0;12
CASINHAS;Vereador;Feminino;9;4;0;5
CASSERENGUE;Vereador;Masculino;22;8;0;14
CASSERENGUE;Vereador;Feminino;11;1;0;10
CÁSSIA;Vereador;Masculino;56;8;0;48
CÁSSIA;Vereador;Feminino;27;1;0;26
CÁSSIA DOS COQUEIROS;Vereador;Masculino;31;8;0;23
CÁSSIA DOS COQUEIROS;Vereador;Feminino;16;1;0;15
CASSILÂNDIA;Vereador;Masculino;58;9;0;49
CASSILÂNDIA;Vereador;Feminino;29;2;0;27
CASTANHAL;Vereador;Masculino;208;16;0;192
CASTANHAL;Vereador;Feminino;93;5;0;88
CASTANHEIRA;Vereador;Masculino;31;8;0;23
CASTANHEIRA;Vereador;Feminino;14;1;0;13
CASTANHEIRAS;Vereador;Masculino;40;8;0;32
CASTANHEIRAS;Vereador;Feminino;19;1;0;18
CASTELÂNDIA;Vereador;Masculino;17;7;0;10
CASTELÂNDIA;Vereador;Feminino;8;2;0;6
CASTELO;Vereador;Masculino;106;13;0;93
CASTELO;Vereador;Feminino;54;0;0;54
CASTELO DO PIAUÍ;Vereador;Masculino;27;10;0;17
CASTELO DO PIAUÍ;Vereador;Feminino;18;1;0;17
CASTILHO;Vereador;Masculino;105;9;0;96
CASTILHO;Vereador;Feminino;50;2;0;48
CASTRO;Vereador;Masculino;93;8;0;85
CASTRO;Vereador;Feminino;45;3;0;42
CASTRO ALVES;Vereador;Masculino;73;10;0;63
CASTRO ALVES;Vereador;Feminino;31;1;0;30
CATAGUASES;Vereador;Masculino;125;15;0;110
CATAGUASES;Vereador;Feminino;57;0;0;57
CATALÃO;Vereador;Masculino;111;16;0;95
CATALÃO;Vereador;Feminino;54;1;0;53
CATANDUVA;Vereador;Masculino;133;13;0;120
CATANDUVA;Vereador;Feminino;62;0;0;62
CATANDUVAS;Vereador;Masculino;38;13;0;25
CATANDUVAS;Vereador;Feminino;19;5;0;14
CATARINA;Vereador;Masculino;22;11;0;11
CATARINA;Vereador;Feminino;9;0;0;9
CATAS ALTAS;Vereador;Masculino;53;6;0;47
CATAS ALTAS;Vereador;Feminino;28;3;0;25
CATAS ALTAS DA NORUEGA;Vereador;Masculino;36;8;0;28
CATAS ALTAS DA NORUEGA;Vereador;Feminino;17;1;0;16
CATENDE;Vereador;Masculino;90;10;0;80
CATENDE;Vereador;Feminino;27;3;0;24
CATIGUÁ;Vereador;Masculino;35;6;0;29
CATIGUÁ;Vereador;Feminino;17;3;0;14
CATINGUEIRA;Vereador;Masculino;22;9;0;13
CATINGUEIRA;Vereador;Feminino;9;0;0;9
CATOLÂNDIA;Vereador;Masculino;20;7;0;13
CATOLÂNDIA;Vereador;Feminino;9;2;0;7
CATOLÉ DO ROCHA;Vereador;Masculino;24;10;0;14
CATOLÉ DO ROCHA;Vereador;Feminino;11;1;0;10
CATU;Vereador;Masculino;84;12;0;72
CATU;Vereador;Feminino;38;1;0;37
CATUÍPE;Vereador;Masculino;22;9;0;13
CATUÍPE;Vereador;Feminino;10;0;0;10
CATUJI;Vereador;Masculino;38;8;0;30
CATUJI;Vereador;Feminino;19;1;0;18
CATUNDA;Vereador;Masculino;19;9;0;10
CATUNDA;Vereador;Feminino;10;0;0;10
CATURAÍ;Vereador;Masculino;35;9;0;26
CATURAÍ;Vereador;Feminino;18;0;0;18
CATURAMA;Vereador;Masculino;31;9;0;22
CATURAMA;Vereador;Feminino;15;0;0;15
CATURITÉ;Vereador;Masculino;35;9;0;26
CATURITÉ;Vereador;Feminino;19;0;0;19
CATUTI;Vereador;Masculino;21;6;0;15
CATUTI;Vereador;Feminino;9;3;0;6
CAUCAIA;Vereador;Masculino;238;14;0;224
CAUCAIA;Vereador;Feminino;105;3;0;102
CAVALCANTE;Vereador;Masculino;56;9;0;47
CAVALCANTE;Vereador;Feminino;11;0;0;11
CAXAMBU;Vereador;Masculino;68;10;0;58
CAXAMBU;Vereador;Feminino;33;1;0;32
CAXAMBU DO SUL;Vereador;Masculino;22;7;0;15
CAXAMBU DO SUL;Vereador;Feminino;10;2;0;8
CAXIAS;Vereador;Masculino;161;14;0;147
CAXIAS;Vereador;Feminino;64;5;0;59
CAXIAS DO SUL;Vereador;Masculino;241;22;0;219
CAXIAS DO SUL;Vereador;Feminino;105;1;0;104
CAXINGÓ;Vereador;Masculino;22;9;0;13
CAXINGÓ;Vereador;Feminino;10;0;0;10
CEARÁ-MIRIM;Vereador;Masculino;78;10;0;68
CEARÁ-MIRIM;Vereador;Feminino;43;3;0;40
CEDRAL;Vereador;Masculino;98;17;0;81
CEDRAL;Vereador;Feminino;49;1;0;48
CEDRO;Vereador;Masculino;47;14;0;33
CEDRO;Vereador;Feminino;24;6;0;18
CEDRO DE SÃO JOÃO;Vereador;Masculino;18;7;0;11
CEDRO DE SÃO JOÃO;Vereador;Feminino;10;2;0;8
CEDRO DO ABAETÉ;Vereador;Masculino;17;6;0;11
CEDRO DO ABAETÉ;Vereador;Feminino;13;3;0;10
CELSO RAMOS;Vereador;Masculino;18;7;0;11
CELSO RAMOS;Vereador;Feminino;7;2;0;5
CENTENÁRIO;Vereador;Masculino;40;15;0;25
CENTENÁRIO;Vereador;Feminino;20;3;0;17
CENTENÁRIO DO SUL;Vereador;Masculino;57;7;0;50
CENTENÁRIO DO SUL;Vereador;Feminino;21;2;0;19
CENTRAL;Vereador;Masculino;24;9;0;15
CENTRAL;Vereador;Feminino;11;2;0;9
CENTRAL DE MINAS;Vereador;Masculino;32;7;0;25
CENTRAL DE MINAS;Vereador;Feminino;16;2;0;14
CENTRAL DO MARANHÃO;Vereador;Masculino;45;7;0;38
CENTRAL DO MARANHÃO;Vereador;Feminino;22;2;0;20
CENTRALINA;Vereador;Masculino;39;7;0;32
CENTRALINA;Vereador;Feminino;18;2;0;16
CENTRO DO GUILHERME;Vereador;Masculino;27;6;0;21
CENTRO DO GUILHERME;Vereador;Feminino;13;3;0;10
CENTRO NOVO DO MARANHÃO;Vereador;Masculino;23;8;0;15
CENTRO NOVO DO MARANHÃO;Vereador;Feminino;11;3;0;8
CEREJEIRAS;Vereador;Masculino;39;9;0;30
CEREJEIRAS;Vereador;Feminino;15;0;0;15
CERES;Vereador;Masculino;66;10;0;56
CERES;Vereador;Feminino;30;1;0;29
CERQUEIRA CÉSAR;Vereador;Masculino;79;10;0;69
CERQUEIRA CÉSAR;Vereador;Feminino;38;1;0;37
CERQUILHO;Vereador;Masculino;99;9;0;90
CERQUILHO;Vereador;Feminino;46;4;0;42
CERRITO;Vereador;Masculino;26;8;0;18
CERRITO;Vereador;Feminino;13;1;0;12
CERRO AZUL;Vereador;Masculino;23;8;0;15
CERRO AZUL;Vereador;Feminino;12;1;0;11
CERRO BRANCO;Vereador;Masculino;24;9;0;15
CERRO BRANCO;Vereador;Feminino;12;0;0;12
CERRO CORÁ;Vereador;Masculino;23;8;0;15
CERRO CORÁ;Vereador;Feminino;11;1;0;10
CERRO GRANDE;Vereador;Masculino;15;7;0;8
CERRO GRANDE;Vereador;Feminino;7;2;0;5
CERRO GRANDE DO SUL;Vereador;Masculino;42;9;0;33
CERRO GRANDE DO SUL;Vereador;Feminino;20;0;0;20
CERRO LARGO;Vereador;Masculino;25;8;0;17
CERRO LARGO;Vereador;Feminino;15;1;0;14
CERRO NEGRO;Vereador;Masculino;15;9;0;6
CERRO NEGRO;Vereador;Feminino;5;0;0;5
CESÁRIO LANGE;Vereador;Masculino;45;11;0;34
CESÁRIO LANGE;Vereador;Feminino;22;0;0;22
CÉU AZUL;Vereador;Masculino;25;8;0;17
CÉU AZUL;Vereador;Feminino;12;1;0;11
CEZARINA;Vereador;Masculino;35;9;0;26
CEZARINA;Vereador;Feminino;14;0;0;14
CHÃ DE ALEGRIA;Vereador;Masculino;68;9;0;59
CHÃ DE ALEGRIA;Vereador;Feminino;13;0;0;13
CHÃ GRANDE;Vereador;Masculino;42;10;0;32
CHÃ GRANDE;Vereador;Feminino;19;1;0;18
CHÃ PRETA;Vereador;Masculino;26;7;0;19
CHÃ PRETA;Vereador;Feminino;13;2;0;11
CHÁCARA;Vereador;Masculino;35;8;0;27
CHÁCARA;Vereador;Feminino;19;1;0;18
CHALÉ;Vereador;Masculino;18;7;0;11
CHALÉ;Vereador;Feminino;10;2;0;8
CHAPADA;Vereador;Masculino;22;8;0;14
CHAPADA;Vereador;Feminino;10;1;0;9
CHAPADA DA NATIVIDADE;Vereador;Masculino;26;9;0;17
CHAPADA DA NATIVIDADE;Vereador;Feminino;14;0;0;14
CHAPADA DE AREIA;Vereador;Masculino;19;8;0;11
CHAPADA DE AREIA;Vereador;Feminino;9;1;0;8
CHAPADA DO NORTE;Vereador;Masculino;26;10;0;16
CHAPADA DO NORTE;Vereador;Feminino;13;1;0;12
CHAPADA DOS GUIMARÃES;Vereador;Masculino;72;9;0;63
CHAPADA DOS GUIMARÃES;Vereador;Feminino;31;2;0;29
CHAPADA GAÚCHA;Vereador;Masculino;42;9;0;33
CHAPADA GAÚCHA;Vereador;Feminino;21;0;0;21
CHAPADÃO DO CÉU;Vereador;Masculino;20;8;0;12
CHAPADÃO DO CÉU;Vereador;Feminino;10;1;0;9
CHAPADÃO DO LAGEADO;Vereador;Masculino;18;8;0;10
CHAPADÃO DO LAGEADO;Vereador;Feminino;9;1;0;8
CHAPADÃO DO SUL;Vereador;Masculino;42;6;0;36
CHAPADÃO DO SUL;Vereador;Feminino;21;3;0;18
CHAPADINHA;Vereador;Masculino;84;10;0;74
CHAPADINHA;Vereador;Feminino;45;5;0;40
CHAPECÓ;Vereador;Masculino;132;19;0;113
CHAPECÓ;Vereador;Feminino;60;2;0;58
CHARQUEADA;Vereador;Masculino;90;9;0;81
CHARQUEADA;Vereador;Feminino;43;2;0;41
CHARQUEADAS;Vereador;Masculino;96;10;0;86
CHARQUEADAS;Vereador;Feminino;43;3;0;40
CHARRUA;Vereador;Masculino;8;7;0;1
CHARRUA;Vereador;Feminino;4;2;0;2
CHAVAL;Vereador;Masculino;17;8;0;9
CHAVAL;Vereador;Feminino;8;1;0;7
CHAVANTES;Vereador;Masculino;56;8;0;48
CHAVANTES;Vereador;Feminino;27;1;0;26
CHAVES;Vereador;Masculino;57;9;0;48
CHAVES;Vereador;Feminino;28;2;0;26
CHIADOR;Vereador;Masculino;26;7;0;19
CHIADOR;Vereador;Feminino;14;2;0;12
CHIAPETTA;Vereador;Masculino;18;7;0;11
CHIAPETTA;Vereador;Feminino;9;2;0;7
CHOPINZINHO;Vereador;Masculino;18;8;0;10
CHOPINZINHO;Vereador;Feminino;9;1;0;8
CHORÓ;Vereador;Masculino;42;9;0;33
CHORÓ;Vereador;Feminino;19;0;0;19
CHOROZINHO;Vereador;Masculino;51;10;0;41
CHOROZINHO;Vereador;Feminino;26;1;0;25
CHORROCHÓ;Vereador;Masculino;22;5;0;17
CHORROCHÓ;Vereador;Feminino;9;4;0;5
CHUÍ;Vereador;Masculino;33;6;0;27
CHUÍ;Vereador;Feminino;17;3;0;14
CHUPINGUAIA;Vereador;Masculino;32;7;0;25
CHUPINGUAIA;Vereador;Feminino;16;2;0;14
CHUVISCA;Vereador;Masculino;26;9;0;17
CHUVISCA;Vereador;Feminino;14;0;0;14
CIANORTE;Vereador;Masculino;70;8;0;62
CIANORTE;Vereador;Feminino;30;2;0;28
CÍCERO DANTAS;Vereador;Masculino;33;11;0;22
CÍCERO DANTAS;Vereador;Feminino;16;2;0;14
CIDADE GAÚCHA;Vereador;Masculino;24;8;0;16
CIDADE GAÚCHA;Vereador;Feminino;11;1;0;10
CIDADE OCIDENTAL;Vereador;Masculino;106;12;0;94
CIDADE OCIDENTAL;Vereador;Feminino;48;1;0;47
CIDELÂNDIA;Vereador;Masculino;28;6;0;22
CIDELÂNDIA;Vereador;Feminino;13;3;0;10
CIDREIRA;Vereador;Masculino;69;8;0;61
CIDREIRA;Vereador;Feminino;42;1;0;41
CIPÓ;Vereador;Masculino;36;8;0;28
CIPÓ;Vereador;Feminino;17;1;0;16
CIPOTÂNEA;Vereador;Masculino;43;9;0;34
CIPOTÂNEA;Vereador;Feminino;20;0;0;20
CIRÍACO;Vereador;Masculino;23;9;0;14
CIRÍACO;Vereador;Feminino;12;0;0;12
CLARAVAL;Vereador;Masculino;37;8;0;29
CLARAVAL;Vereador;Feminino;20;1;0;19
CLARO DOS POÇÕES;Vereador;Masculino;35;7;0;28
CLARO DOS POÇÕES;Vereador;Feminino;18;2;0;16
CLÁUDIA;Vereador;Masculino;22;7;0;15
CLÁUDIA;Vereador;Feminino;10;2;0;8
CLÁUDIO;Vereador;Masculino;64;10;0;54
CLÁUDIO;Vereador;Feminino;32;1;0;31
CLEMENTINA;Vereador;Masculino;28;8;0;20
CLEMENTINA;Vereador;Feminino;15;1;0;14
CLEVELÂNDIA;Vereador;Masculino;35;7;0;28
CLEVELÂNDIA;Vereador;Feminino;16;2;0;14
COARACI;Vereador;Masculino;86;10;0;76
COARACI;Vereador;Feminino;40;1;0;39
COARI;Vereador;Masculino;110;15;0;95
COARI;Vereador;Feminino;49;0;0;49
COCAL;Vereador;Masculino;51;9;0;42
COCAL;Vereador;Feminino;28;2;0;26
COCAL DE TELHA;Vereador;Masculino;17;7;0;10
COCAL DE TELHA;Vereador;Feminino;10;2;0;8
COCAL DO SUL;Vereador;Masculino;46;6;0;40
COCAL DO SUL;Vereador;Feminino;22;3;0;19
COCAL DOS ALVES;Vereador;Masculino;18;9;0;9
COCAL DOS ALVES;Vereador;Feminino;9;0;0;9
COCALINHO;Vereador;Masculino;27;7;0;20
COCALINHO;Vereador;Feminino;15;2;0;13
COCALZINHO DE GOIÁS;Vereador;Masculino;95;11;0;84
COCALZINHO DE GOIÁS;Vereador;Feminino;43;0;0;43
COCOS;Vereador;Masculino;26;8;0;18
COCOS;Vereador;Feminino;16;3;0;13
CODAJÁS;Vereador;Masculino;52;10;0;42
CODAJÁS;Vereador;Feminino;24;1;0;23
CODÓ;Vereador;Masculino;102;10;0;92
CODÓ;Vereador;Feminino;45;1;0;44
COELHO NETO;Vereador;Masculino;87;11;0;76
COELHO NETO;Vereador;Feminino;36;2;0;34
COIMBRA;Vereador;Masculino;18;9;0;9
COIMBRA;Vereador;Feminino;9;0;0;9
COITÉ DO NÓIA;Vereador;Masculino;21;9;0;12
COITÉ DO NÓIA;Vereador;Feminino;10;0;0;10
COIVARAS;Vereador;Masculino;22;5;0;17
COIVARAS;Vereador;Feminino;11;4;0;7
COLARES;Vereador;Masculino;52;8;0;44
COLARES;Vereador;Feminino;25;1;0;24
COLATINA;Vereador;Masculino;104;15;0;89
COLATINA;Vereador;Feminino;50;0;0;50
COLÍDER;Vereador;Masculino;64;11;0;53
COLÍDER;Vereador;Feminino;31;2;0;29
COLINA;Vereador;Masculino;48;10;0;38
COLINA;Vereador;Feminino;27;1;0;26
COLINAS;Vereador;Masculino;70;16;0;54
COLINAS;Vereador;Feminino;34;6;0;28
COLINAS DO SUL;Vereador;Masculino;30;9;0;21
COLINAS DO SUL;Vereador;Feminino;13;0;0;13
COLINAS DO TOCANTINS;Vereador;Masculino;68;11;0;57
COLINAS DO TOCANTINS;Vereador;Feminino;33;2;0;31
COLMÉIA;Vereador;Masculino;34;8;0;26
COLMÉIA;Vereador;Feminino;17;1;0;16
COLNIZA;Vereador;Masculino;66;9;0;57
COLNIZA;Vereador;Feminino;35;0;0;35
COLÔMBIA;Vereador;Masculino;45;7;0;38
COLÔMBIA;Vereador;Feminino;24;2;0;22
COLOMBO;Vereador;Masculino;264;19;0;245
COLOMBO;Vereador;Feminino;108;2;0;106
COLÔNIA DO GURGUÉIA;Vereador;Masculino;29;6;0;23
COLÔNIA DO GURGUÉIA;Vereador;Feminino;15;3;0;12
COLÔNIA DO PIAUÍ;Vereador;Masculino;15;6;0;9
COLÔNIA DO PIAUÍ;Vereador;Feminino;8;3;0;5
COLÔNIA LEOPOLDINA;Vereador;Masculino;25;9;0;16
COLÔNIA LEOPOLDINA;Vereador;Feminino;15;2;0;13
COLORADO;Vereador;Masculino;64;13;0;51
COLORADO;Vereador;Feminino;33;5;0;28
COLORADO DO OESTE;Vereador;Masculino;50;9;0;41
COLORADO DO OESTE;Vereador;Feminino;18;2;0;16
COLUNA;Vereador;Masculino;24;6;0;18
COLUNA;Vereador;Feminino;12;3;0;9
COMBINADO;Vereador;Masculino;26;9;0;17
COMBINADO;Vereador;Feminino;7;0;0;7
COMENDADOR GOMES;Vereador;Masculino;20;9;0;11
COMENDADOR GOMES;Vereador;Feminino;10;0;0;10
COMENDADOR LEVY GASPARIAN;Vereador;Masculino;51;8;0;43
COMENDADOR LEVY GASPARIAN;Vereador;Feminino;29;1;0;28
COMERCINHO;Vereador;Masculino;26;7;0;19
COMERCINHO;Vereador;Feminino;13;2;0;11
COMODORO;Vereador;Masculino;61;11;0;50
COMODORO;Vereador;Feminino;30;0;0;30
CONCEIÇÃO;Vereador;Masculino;27;9;0;18
CONCEIÇÃO;Vereador;Feminino;13;2;0;11
CONCEIÇÃO DA APARECIDA;Vereador;Masculino;53;9;0;44
CONCEIÇÃO DA APARECIDA;Vereador;Feminino;24;0;0;24
CONCEIÇÃO DA BARRA;Vereador;Masculino;75;8;0;67
CONCEIÇÃO DA BARRA;Vereador;Feminino;34;3;0;31
CONCEIÇÃO DA BARRA DE MINAS;Vereador;Masculino;44;9;0;35
CONCEIÇÃO DA BARRA DE MINAS;Vereador;Feminino;22;0;0;22
CONCEIÇÃO DA FEIRA;Vereador;Masculino;72;7;0;65
CONCEIÇÃO DA FEIRA;Vereador;Feminino;36;2;0;34
CONCEIÇÃO DAS ALAGOAS;Vereador;Masculino;36;9;0;27
CONCEIÇÃO DAS ALAGOAS;Vereador;Feminino;17;2;0;15
CONCEIÇÃO DAS PEDRAS;Vereador;Masculino;19;8;0;11
CONCEIÇÃO DAS PEDRAS;Vereador;Feminino;9;1;0;8
CONCEIÇÃO DE IPANEMA;Vereador;Masculino;31;9;0;22
CONCEIÇÃO DE IPANEMA;Vereador;Feminino;15;0;0;15
CONCEIÇÃO DE MACABU;Vereador;Masculino;96;9;0;87
CONCEIÇÃO DE MACABU;Vereador;Feminino;48;2;0;46
CONCEIÇÃO DO ALMEIDA;Vereador;Masculino;65;10;0;55
CONCEIÇÃO DO ALMEIDA;Vereador;Feminino;31;1;0;30
CONCEIÇÃO DO ARAGUAIA;Vereador;Masculino;104;11;0;93
CONCEIÇÃO DO ARAGUAIA;Vereador;Feminino;44;2;0;42
CONCEIÇÃO DO CANINDÉ;Vereador;Masculino;18;8;0;10
CONCEIÇÃO DO CANINDÉ;Vereador;Feminino;9;1;0;8
CONCEIÇÃO DO CASTELO;Vereador;Masculino;46;9;0;37
CONCEIÇÃO DO CASTELO;Vereador;Feminino;22;0;0;22
CONCEIÇÃO DO COITÉ;Vereador;Masculino;77;12;0;65
CONCEIÇÃO DO COITÉ;Vereador;Feminino;35;3;0;32
CONCEIÇÃO DO JACUÍPE;Vereador;Masculino;53;9;0;44
CONCEIÇÃO DO JACUÍPE;Vereador;Feminino;21;4;0;17
CONCEIÇÃO DO LAGO-AÇU;Vereador;Masculino;59;8;0;51
CONCEIÇÃO DO LAGO-AÇU;Vereador;Feminino;30;1;0;29
CONCEIÇÃO DO MATO DENTRO;Vereador;Masculino;59;8;0;51
CONCEIÇÃO DO MATO DENTRO;Vereador;Feminino;29;3;0;26
CONCEIÇÃO DO PARÁ;Vereador;Masculino;48;9;0;39
CONCEIÇÃO DO PARÁ;Vereador;Feminino;25;0;0;25
CONCEIÇÃO DO RIO VERDE;Vereador;Masculino;94;6;0;88
CONCEIÇÃO DO RIO VERDE;Vereador;Feminino;54;3;0;51
CONCEIÇÃO DO TOCANTINS;Vereador;Masculino;23;8;0;15
CONCEIÇÃO DO TOCANTINS;Vereador;Feminino;11;1;0;10
CONCEIÇÃO DOS OUROS;Vereador;Masculino;49;8;0;41
CONCEIÇÃO DOS OUROS;Vereador;Feminino;23;1;0;22
CONCHAL;Vereador;Masculino;113;9;0;104
CONCHAL;Vereador;Feminino;49;2;0;47
CONCHAS;Vereador;Masculino;57;9;0;48
CONCHAS;Vereador;Feminino;28;0;0;28
CONCÓRDIA;Vereador;Masculino;56;12;0;44
CONCÓRDIA;Vereador;Feminino;26;1;0;25
CONCÓRDIA DO PARÁ;Vereador;Masculino;54;10;0;44
CONCÓRDIA DO PARÁ;Vereador;Feminino;25;1;0;24
CONDADO;Vereador;Masculino;66;15;0;51
CONDADO;Vereador;Feminino;33;3;0;30
CONDE;Vereador;Masculino;174;20;0;154
CONDE;Vereador;Feminino;82;2;0;80
CONDEÚBA;Vereador;Masculino;49;8;0;41
CONDEÚBA;Vereador;Feminino;28;3;0;25
CONDOR;Vereador;Masculino;19;9;0;10
CONDOR;Vereador;Feminino;11;0;0;11
CÔNEGO MARINHO;Vereador;Masculino;39;8;0;31
CÔNEGO MARINHO;Vereador;Feminino;18;1;0;17
CONFINS;Vereador;Masculino;61;8;0;53
CONFINS;Vereador;Feminino;30;1;0;29
CONFRESA;Vereador;Masculino;56;9;0;47
CONFRESA;Vereador;Feminino;27;2;0;25
CONGO;Vereador;Masculino;17;8;0;9
CONGO;Vereador;Feminino;8;1;0;7
CONGONHAL;Vereador;Masculino;25;6;0;19
CONGONHAL;Vereador;Feminino;11;3;0;8
CONGONHAS;Vereador;Masculino;108;12;0;96
CONGONHAS;Vereador;Feminino;48;1;0;47
CONGONHAS DO NORTE;Vereador;Masculino;32;9;0;23
CONGONHAS DO NORTE;Vereador;Feminino;16;0;0;16
CONGONHINHAS;Vereador;Masculino;42;8;0;34
CONGONHINHAS;Vereador;Feminino;21;1;0;20
CONQUISTA;Vereador;Masculino;35;8;0;27
CONQUISTA;Vereador;Feminino;18;1;0;17
CONQUISTA D'OESTE;Vereador;Masculino;38;6;0;32
CONQUISTA D'OESTE;Vereador;Feminino;23;3;0;20
CONSELHEIRO LAFAIETE;Vereador;Masculino;132;13;0;119
CONSELHEIRO LAFAIETE;Vereador;Feminino;59;0;0;59
CONSELHEIRO MAIRINCK;Vereador;Masculino;22;9;0;13
CONSELHEIRO MAIRINCK;Vereador;Feminino;11;0;0;11
CONSELHEIRO PENA;Vereador;Masculino;52;11;0;41
CONSELHEIRO PENA;Vereador;Feminino;24;0;0;24
CONSOLAÇÃO;Vereador;Masculino;22;9;0;13
CONSOLAÇÃO;Vereador;Feminino;11;0;0;11
CONSTANTINA;Vereador;Masculino;23;8;0;15
CONSTANTINA;Vereador;Feminino;11;1;0;10
CONTAGEM;Vereador;Masculino;362;20;0;342
CONTAGEM;Vereador;Feminino;161;1;0;160
CONTENDA;Vereador;Masculino;56;9;0;47
CONTENDA;Vereador;Feminino;22;0;0;22
CONTENDAS DO SINCORÁ;Vereador;Masculino;19;9;0;10
CONTENDAS DO SINCORÁ;Vereador;Feminino;11;0;0;11
COQUEIRAL;Vereador;Masculino;51;8;0;43
COQUEIRAL;Vereador;Feminino;25;1;0;24
COQUEIRO BAIXO;Vereador;Masculino;18;9;0;9
COQUEIRO BAIXO;Vereador;Feminino;8;0;0;8
COQUEIRO SECO;Vereador;Masculino;43;8;0;35
COQUEIRO SECO;Vereador;Feminino;21;1;0;20
COQUEIROS DO SUL;Vereador;Masculino;16;7;0;9
COQUEIROS DO SUL;Vereador;Feminino;9;2;0;7
CORAÇÃO DE JESUS;Vereador;Masculino;81;11;0;70
CORAÇÃO DE JESUS;Vereador;Feminino;38;0;0;38
CORAÇÃO DE MARIA;Vereador;Masculino;52;10;0;42
CORAÇÃO DE MARIA;Vereador;Feminino;22;1;0;21
CORBÉLIA;Vereador;Masculino;28;10;0;18
CORBÉLIA;Vereador;Feminino;12;1;0;11
CORDEIRO;Vereador;Masculino;78;10;0;68
CORDEIRO;Vereador;Feminino;41;1;0;40
CORDEIRÓPOLIS;Vereador;Masculino;74;7;0;67
CORDEIRÓPOLIS;Vereador;Feminino;41;2;0;39
CORDEIROS;Vereador;Masculino;23;9;0;14
CORDEIROS;Vereador;Feminino;11;0;0;11
CORDILHEIRA ALTA;Vereador;Masculino;22;9;0;13
CORDILHEIRA ALTA;Vereador;Feminino;11;0;0;11
CORDISBURGO;Vereador;Masculino;44;8;0;36
CORDISBURGO;Vereador;Feminino;22;1;0;21
CORDISLÂNDIA;Vereador;Masculino;39;6;0;33
CORDISLÂNDIA;Vereador;Feminino;19;3;0;16
COREAÚ;Vereador;Masculino;19;8;0;11
COREAÚ;Vereador;Feminino;10;1;0;9
COREMAS;Vereador;Masculino;26;10;0;16
COREMAS;Vereador;Feminino;12;1;0;11
CORGUINHO;Vereador;Masculino;36;8;0;28
CORGUINHO;Vereador;Feminino;17;1;0;16
CORIBE;Vereador;Masculino;26;9;0;17
CORIBE;Vereador;Feminino;12;0;0;12
CORINTO;Vereador;Masculino;87;11;0;76
CORINTO;Vereador;Feminino;41;0;0;41
CORNÉLIO PROCÓPIO;Vereador;Masculino;89;9;0;80
CORNÉLIO PROCÓPIO;Vereador;Feminino;42;2;0;40
COROACI;Vereador;Masculino;48;5;0;43
COROACI;Vereador;Feminino;23;4;0;19
COROADOS;Vereador;Masculino;39;6;0;33
COROADOS;Vereador;Feminino;19;3;0;16
COROATÁ;Vereador;Masculino;76;12;0;64
COROATÁ;Vereador;Feminino;36;1;0;35
COROMANDEL;Vereador;Masculino;44;11;0;33
COROMANDEL;Vereador;Feminino;22;0;0;22
CORONEL BARROS;Vereador;Masculino;18;8;0;10
CORONEL BARROS;Vereador;Feminino;10;1;0;9
CORONEL BICACO;Vereador;Masculino;21;8;0;13
CORONEL BICACO;Vereador;Feminino;11;1;0;10
CORONEL DOMINGOS SOARES;Vereador;Masculino;34;7;0;27
CORONEL DOMINGOS SOARES;Vereador;Feminino;12;2;0;10
CORONEL EZEQUIEL;Vereador;Masculino;30;9;0;21
CORONEL EZEQUIEL;Vereador;Feminino;14;0;0;14
CORONEL FABRICIANO;Vereador;Masculino;136;14;0;122
CORONEL FABRICIANO;Vereador;Feminino;61;3;0;58
CORONEL FREITAS;Vereador;Masculino;23;8;0;15
CORONEL FREITAS;Vereador;Feminino;12;1;0;11
CORONEL JOÃO PESSOA;Vereador;Masculino;9;8;0;1
CORONEL JOÃO PESSOA;Vereador;Feminino;4;1;0;3
CORONEL JOÃO SÁ;Vereador;Masculino;25;9;0;16
CORONEL JOÃO SÁ;Vereador;Feminino;12;2;0;10
CORONEL JOSÉ DIAS;Vereador;Masculino;15;8;0;7
CORONEL JOSÉ DIAS;Vereador;Feminino;9;1;0;8
CORONEL MACEDO;Vereador;Masculino;21;8;0;13
CORONEL MACEDO;Vereador;Feminino;9;1;0;8
CORONEL MARTINS;Vereador;Masculino;23;9;0;14
CORONEL MARTINS;Vereador;Feminino;11;0;0;11
CORONEL MURTA;Vereador;Masculino;35;9;0;26
CORONEL MURTA;Vereador;Feminino;18;0;0;18
CORONEL PACHECO;Vereador;Masculino;45;9;0;36
CORONEL PACHECO;Vereador;Feminino;23;0;0;23
CORONEL PILAR;Vereador;Masculino;14;7;0;7
CORONEL PILAR;Vereador;Feminino;7;2;0;5
CORONEL SAPUCAIA;Vereador;Masculino;23;5;0;18
CORONEL SAPUCAIA;Vereador;Feminino;12;4;0;8
CORONEL VIVIDA;Vereador;Masculino;28;7;0;21
CORONEL VIVIDA;Vereador;Feminino;11;2;0;9
CORONEL XAVIER CHAVES;Vereador;Masculino;25;8;0;17
CORONEL XAVIER CHAVES;Vereador;Feminino;16;1;0;15
CÓRREGO DANTA;Vereador;Masculino;42;9;0;33
CÓRREGO DANTA;Vereador;Feminino;22;0;0;22
CÓRREGO DO BOM JESUS;Vereador;Masculino;26;8;0;18
CÓRREGO DO BOM JESUS;Vereador;Feminino;14;1;0;13
CÓRREGO DO OURO;Vereador;Masculino;17;8;0;9
CÓRREGO DO OURO;Vereador;Feminino;8;1;0;7
CÓRREGO FUNDO;Vereador;Masculino;41;8;0;33
CÓRREGO FUNDO;Vereador;Feminino;21;1;0;20
CÓRREGO NOVO;Vereador;Masculino;23;8;0;15
CÓRREGO NOVO;Vereador;Feminino;12;1;0;11
CORREIA PINTO;Vereador;Masculino;28;9;0;19
CORREIA PINTO;Vereador;Feminino;14;0;0;14
CORRENTE;Vereador;Masculino;32;9;0;23
CORRENTE;Vereador;Feminino;15;2;0;13
CORRENTES;Vereador;Masculino;21;8;0;13
CORRENTES;Vereador;Feminino;10;1;0;9
CORRENTINA;Vereador;Masculino;63;11;0;52
CORRENTINA;Vereador;Feminino;27;2;0;25
CORTÊS;Vereador;Masculino;35;8;0;27
CORTÊS;Vereador;Feminino;12;1;0;11
CORUMBÁ;Vereador;Masculino;112;14;0;98
CORUMBÁ;Vereador;Feminino;52;1;0;51
CORUMBÁ DE GOIÁS;Vereador;Masculino;43;9;0;34
CORUMBÁ DE GOIÁS;Vereador;Feminino;21;0;0;21
CORUMBAÍBA;Vereador;Masculino;22;6;0;16
CORUMBAÍBA;Vereador;Feminino;12;3;0;9
CORUMBATAÍ;Vereador;Masculino;36;7;0;29
CORUMBATAÍ;Vereador;Feminino;23;2;0;21
CORUMBATAÍ DO SUL;Vereador;Masculino;46;9;0;37
CORUMBATAÍ DO SUL;Vereador;Feminino;28;0;0;28
CORUMBIARA;Vereador;Masculino;47;8;0;39
CORUMBIARA;Vereador;Feminino;20;1;0;19
CORUPÁ;Vereador;Masculino;37;9;0;28
CORUPÁ;Vereador;Feminino;20;0;0;20
CORURIPE;Vereador;Masculino;66;14;0;52
CORURIPE;Vereador;Feminino;28;1;0;27
COSMÓPOLIS;Vereador;Masculino;126;11;0;115
COSMÓPOLIS;Vereador;Feminino;63;1;0;62
COSMORAMA;Vereador;Masculino;22;7;0;15
COSMORAMA;Vereador;Feminino;11;2;0;9
COSTA MARQUES;Vereador;Masculino;41;9;0;32
COSTA MARQUES;Vereador;Feminino;20;0;0;20
COSTA RICA;Vereador;Masculino;48;10;0;38
COSTA RICA;Vereador;Feminino;23;1;0;22
COTEGIPE;Vereador;Masculino;31;8;0;23
COTEGIPE;Vereador;Feminino;15;1;0;14
COTIA;Vereador;Masculino;137;13;0;124
COTIA;Vereador;Feminino;56;0;0;56
COTIPORÃ;Vereador;Masculino;19;7;0;12
COTIPORÃ;Vereador;Feminino;12;2;0;10
COTRIGUAÇU;Vereador;Masculino;53;8;0;45
COTRIGUAÇU;Vereador;Feminino;31;1;0;30
COUTO DE MAGALHÃES;Vereador;Masculino;42;9;0;33
COUTO DE MAGALHÃES;Vereador;Feminino;21;0;0;21
COUTO DE MAGALHÃES DE MINAS;Vereador;Masculino;39;7;0;32
COUTO DE MAGALHÃES DE MINAS;Vereador;Feminino;19;2;0;17
COXILHA;Vereador;Masculino;19;8;0;11
COXILHA;Vereador;Feminino;12;1;0;11
COXIM;Vereador;Masculino;83;11;0;72
COXIM;Vereador;Feminino;37;2;0;35
COXIXOLA;Vereador;Masculino;19;7;0;12
COXIXOLA;Vereador;Feminino;8;2;0;6
CRAÍBAS;Vereador;Masculino;50;10;0;40
CRAÍBAS;Vereador;Feminino;22;1;0;21
CRATEÚS;Vereador;Masculino;60;14;0;46
CRATEÚS;Vereador;Feminino;31;1;0;30
CRATO;Vereador;Masculino;141;18;0;123
CRATO;Vereador;Feminino;47;1;0;46
CRAVINHOS;Vereador;Masculino;91;13;0;78
CRAVINHOS;Vereador;Feminino;36;0;0;36
CRAVOLÂNDIA;Vereador;Masculino;26;9;0;17
CRAVOLÂNDIA;Vereador;Feminino;13;0;0;13
CRICIÚMA;Vereador;Masculino;120;14;0;106
CRICIÚMA;Vereador;Feminino;54;3;0;51
CRISÓLITA;Vereador;Masculino;37;8;0;29
CRISÓLITA;Vereador;Feminino;20;1;0;19
CRISÓPOLIS;Vereador;Masculino;24;10;0;14
CRISÓPOLIS;Vereador;Feminino;8;1;0;7
CRISSIUMAL;Vereador;Masculino;35;8;0;27
CRISSIUMAL;Vereador;Feminino;16;1;0;15
CRISTAIS;Vereador;Masculino;70;8;0;62
CRISTAIS;Vereador;Feminino;36;1;0;35
CRISTAIS PAULISTA;Vereador;Masculino;53;8;0;45
CRISTAIS PAULISTA;Vereador;Feminino;25;1;0;24
CRISTAL;Vereador;Masculino;48;7;0;41
CRISTAL;Vereador;Feminino;24;2;0;22
CRISTAL DO SUL;Vereador;Masculino;23;9;0;14
CRISTAL DO SUL;Vereador;Feminino;11;0;0;11
CRISTALÂNDIA;Vereador;Masculino;25;8;0;17
CRISTALÂNDIA;Vereador;Feminino;10;1;0;9
CRISTALÂNDIA DO PIAUÍ;Vereador;Masculino;23;9;0;14
CRISTALÂNDIA DO PIAUÍ;Vereador;Feminino;11;0;0;11
CRISTÁLIA;Vereador;Masculino;19;7;0;12
CRISTÁLIA;Vereador;Feminino;10;2;0;8
CRISTALINA;Vereador;Masculino;88;10;0;78
CRISTALINA;Vereador;Feminino;38;3;0;35
CRISTIANO OTONI;Vereador;Masculino;38;8;0;30
CRISTIANO OTONI;Vereador;Feminino;22;1;0;21
CRISTIANÓPOLIS;Vereador;Masculino;23;9;0;14
CRISTIANÓPOLIS;Vereador;Feminino;10;0;0;10
CRISTINA;Vereador;Masculino;41;8;0;33
CRISTINA;Vereador;Feminino;19;1;0;18
CRISTINÁPOLIS;Vereador;Masculino;39;8;0;31
CRISTINÁPOLIS;Vereador;Feminino;20;3;0;17
CRISTINO CASTRO;Vereador;Masculino;46;6;0;40
CRISTINO CASTRO;Vereador;Feminino;21;3;0;18
CRISTÓPOLIS;Vereador;Masculino;24;8;0;16
CRISTÓPOLIS;Vereador;Feminino;11;1;0;10
CRIXÁS;Vereador;Masculino;73;9;0;64
CRIXÁS;Vereador;Feminino;24;2;0;22
CRIXÁS DO TOCANTINS;Vereador;Masculino;25;7;0;18
CRIXÁS DO TOCANTINS;Vereador;Feminino;13;2;0;11
CROATÁ;Vereador;Masculino;32;7;0;25
CROATÁ;Vereador;Feminino;15;4;0;11
CROMÍNIA;Vereador;Masculino;28;8;0;20
CROMÍNIA;Vereador;Feminino;12;1;0;11
CRUCILÂNDIA;Vereador;Masculino;43;9;0;34
CRUCILÂNDIA;Vereador;Feminino;16;0;0;16
CRUZ;Vereador;Masculino;23;11;0;12
CRUZ;Vereador;Feminino;11;0;0;11
CRUZ ALTA;Vereador;Masculino;85;14;0;71
CRUZ ALTA;Vereador;Feminino;42;1;0;41
CRUZ DAS ALMAS;Vereador;Masculino;116;15;0;101
CRUZ DAS ALMAS;Vereador;Feminino;40;0;0;40
CRUZ DO ESPÍRITO SANTO;Vereador;Masculino;71;10;0;61
CRUZ DO ESPÍRITO SANTO;Vereador;Feminino;30;1;0;29
CRUZ MACHADO;Vereador;Masculino;55;11;0;44
CRUZ MACHADO;Vereador;Feminino;9;0;0;9
CRUZÁLIA;Vereador;Masculino;21;7;0;14
CRUZÁLIA;Vereador;Feminino;11;2;0;9
CRUZALTENSE;Vereador;Masculino;15;8;0;7
CRUZALTENSE;Vereador;Feminino;7;1;0;6
CRUZEIRO;Vereador;Masculino;95;9;0;86
CRUZEIRO;Vereador;Feminino;42;1;0;41
CRUZEIRO DA FORTALEZA;Vereador;Masculino;30;8;0;22
CRUZEIRO DA FORTALEZA;Vereador;Feminino;15;1;0;14
CRUZEIRO DO IGUAÇU;Vereador;Masculino;29;7;0;22
CRUZEIRO DO IGUAÇU;Vereador;Feminino;13;2;0;11
CRUZEIRO DO OESTE;Vereador;Masculino;78;11;0;67
CRUZEIRO DO OESTE;Vereador;Feminino;26;0;0;26
CRUZEIRO DO SUL;Vereador;Masculino;202;25;0;177
CRUZEIRO DO SUL;Vereador;Feminino;93;7;0;86
CRUZETA;Vereador;Masculino;16;5;0;11
CRUZETA;Vereador;Feminino;8;4;0;4
CRUZÍLIA;Vereador;Masculino;44;6;0;38
CRUZÍLIA;Vereador;Feminino;25;3;0;22
CRUZMALTINA;Vereador;Masculino;18;6;0;12
CRUZMALTINA;Vereador;Feminino;8;3;0;5
CUBATÃO;Vereador;Masculino;103;11;0;92
CUBATÃO;Vereador;Feminino;49;0;0;49
CUBATI;Vereador;Masculino;26;8;0;18
CUBATI;Vereador;Feminino;13;1;0;12
CUIABÁ;Vereador;Masculino;357;24;0;333
CUIABÁ;Vereador;Feminino;158;1;0;157
CUITÉ;Vereador;Masculino;29;9;0;20
CUITÉ;Vereador;Feminino;14;2;0;12
CUITÉ DE MAMANGUAPE;Vereador;Masculino;31;9;0;22
CUITÉ DE MAMANGUAPE;Vereador;Feminino;15;0;0;15
CUITEGI;Vereador;Masculino;30;7;0;23
CUITEGI;Vereador;Feminino;16;2;0;14
CUJUBIM;Vereador;Masculino;45;11;0;34
CUJUBIM;Vereador;Feminino;21;0;0;21
CUMARI;Vereador;Masculino;16;9;0;7
CUMARI;Vereador;Feminino;8;0;0;8
CUMARU;Vereador;Masculino;26;10;0;16
CUMARU;Vereador;Feminino;12;1;0;11
CUMARU DO NORTE;Vereador;Masculino;46;8;0;38
CUMARU DO NORTE;Vereador;Feminino;22;1;0;21
CUMBE;Vereador;Masculino;22;8;0;14
CUMBE;Vereador;Feminino;11;1;0;10
CUNHA;Vereador;Masculino;53;11;0;42
CUNHA;Vereador;Feminino;25;0;0;25
CUNHA PORÃ;Vereador;Masculino;20;7;0;13
CUNHA PORÃ;Vereador;Feminino;11;2;0;9
CUNHATAÍ;Vereador;Masculino;18;9;0;9
CUNHATAÍ;Vereador;Feminino;8;0;0;8
CUPARAQUE;Vereador;Masculino;28;8;0;20
CUPARAQUE;Vereador;Feminino;14;1;0;13
CUPIRA;Vereador;Masculino;41;9;0;32
CUPIRA;Vereador;Feminino;20;2;0;18
CURAÇÁ;Vereador;Masculino;57;9;0;48
CURAÇÁ;Vereador;Feminino;34;4;0;30
CURIMATÁ;Vereador;Masculino;27;6;0;21
CURIMATÁ;Vereador;Feminino;14;3;0;11
CURIONÓPOLIS;Vereador;Masculino;50;9;0;41
CURIONÓPOLIS;Vereador;Feminino;26;2;0;24
CURITIBA;Vereador;Masculino;510;33;0;477
CURITIBA;Vereador;Feminino;198;5;0;193
CURITIBANOS;Vereador;Masculino;51;10;0;41
CURITIBANOS;Vereador;Feminino;23;3;0;20
CURIÚVA;Vereador;Masculino;40;8;0;32
CURIÚVA;Vereador;Feminino;21;1;0;20
CURRAIS;Vereador;Masculino;32;9;0;23
CURRAIS;Vereador;Feminino;17;0;0;17
CURRAIS NOVOS;Vereador;Masculino;55;8;0;47
CURRAIS NOVOS;Vereador;Feminino;29;3;0;26
CURRAL DE CIMA;Vereador;Masculino;21;7;0;14
CURRAL DE CIMA;Vereador;Feminino;9;2;0;7
CURRAL DE DENTRO;Vereador;Masculino;25;7;0;18
CURRAL DE DENTRO;Vereador;Feminino;15;2;0;13
CURRAL NOVO DO PIAUÍ;Vereador;Masculino;7;6;0;1
CURRAL NOVO DO PIAUÍ;Vereador;Feminino;6;3;0;3
CURRAL VELHO;Vereador;Masculino;7;7;0;0
CURRAL VELHO;Vereador;Feminino;4;2;0;2
CURRALINHO;Vereador;Masculino;74;9;0;65
CURRALINHO;Vereador;Feminino;38;2;0;36
CURRALINHOS;Vereador;Masculino;41;9;0;32
CURRALINHOS;Vereador;Feminino;21;0;0;21
CURUÁ;Vereador;Masculino;50;7;0;43
CURUÁ;Vereador;Feminino;28;2;0;26
CURUÇÁ;Vereador;Masculino;93;11;0;82
CURUÇÁ;Vereador;Feminino;41;2;0;39
CURURUPU;Vereador;Masculino;63;12;0;51
CURURUPU;Vereador;Feminino;26;1;0;25
CURVELÂNDIA;Vereador;Masculino;30;9;0;21
CURVELÂNDIA;Vereador;Feminino;13;0;0;13
CURVELO;Vereador;Masculino;133;14;0;119
CURVELO;Vereador;Feminino;61;1;0;60
CUSTÓDIA;Vereador;Masculino;37;10;0;27
CUSTÓDIA;Vereador;Feminino;17;1;0;16
CUTIAS;Vereador;Masculino;43;7;0;36
CUTIAS;Vereador;Feminino;20;2;0;18
DAMIANÓPOLIS;Vereador;Masculino;15;6;0;9
DAMIANÓPOLIS;Vereador;Feminino;7;3;0;4
DAMIÃO;Vereador;Masculino;19;7;0;12
DAMIÃO;Vereador;Feminino;9;2;0;7
DAMOLÂNDIA;Vereador;Masculino;24;8;0;16
DAMOLÂNDIA;Vereador;Feminino;12;1;0;11
DARCINÓPOLIS;Vereador;Masculino;31;8;0;23
DARCINÓPOLIS;Vereador;Feminino;14;1;0;13
DÁRIO MEIRA;Vereador;Masculino;37;9;0;28
DÁRIO MEIRA;Vereador;Feminino;14;0;0;14
DATAS;Vereador;Masculino;42;9;0;33
DATAS;Vereador;Feminino;21;0;0;21
DAVID CANABARRO;Vereador;Masculino;22;7;0;15
DAVID CANABARRO;Vereador;Feminino;11;2;0;9
DAVINÓPOLIS;Vereador;Masculino;65;17;0;48
DAVINÓPOLIS;Vereador;Feminino;32;1;0;31
DELFIM MOREIRA;Vereador;Masculino;38;8;0;30
DELFIM MOREIRA;Vereador;Feminino;21;1;0;20
DELFINÓPOLIS;Vereador;Masculino;28;6;0;22
DELFINÓPOLIS;Vereador;Feminino;12;3;0;9
DELMIRO GOUVEIA;Vereador;Masculino;44;10;0;34
DELMIRO GOUVEIA;Vereador;Feminino;17;1;0;16
DELTA;Vereador;Masculino;47;8;0;39
DELTA;Vereador;Feminino;23;1;0;22
DEMERVAL LOBÃO;Vereador;Masculino;46;7;0;39
DEMERVAL LOBÃO;Vereador;Feminino;22;2;0;20
DENISE;Vereador;Masculino;36;6;0;30
DENISE;Vereador;Feminino;21;3;0;18
DEODÁPOLIS;Vereador;Masculino;41;8;0;33
DEODÁPOLIS;Vereador;Feminino;19;1;0;18
DEPUTADO IRAPUAN PINHEIRO;Vereador;Masculino;18;7;0;11
DEPUTADO IRAPUAN PINHEIRO;Vereador;Feminino;10;2;0;8
DERRUBADAS;Vereador;Masculino;12;8;0;4
DERRUBADAS;Vereador;Feminino;6;1;0;5
DESCALVADO;Vereador;Masculino;71;10;0;61
DESCALVADO;Vereador;Feminino;32;1;0;31
DESCANSO;Vereador;Masculino;18;7;0;11
DESCANSO;Vereador;Feminino;11;2;0;9
DESCOBERTO;Vereador;Masculino;31;7;0;24
DESCOBERTO;Vereador;Feminino;17;2;0;15
DESTERRO;Vereador;Masculino;22;6;0;16
DESTERRO;Vereador;Feminino;13;3;0;10
DESTERRO DE ENTRE RIOS;Vereador;Masculino;46;8;0;38
DESTERRO DE ENTRE RIOS;Vereador;Feminino;22;1;0;21
DESTERRO DO MELO;Vereador;Masculino;23;9;0;14
DESTERRO DO MELO;Vereador;Feminino;10;0;0;10
DEZESSEIS DE NOVEMBRO;Vereador;Masculino;12;9;0;3
DEZESSEIS DE NOVEMBRO;Vereador;Feminino;6;0;0;6
DIADEMA;Vereador;Masculino;287;19;0;268
DIADEMA;Vereador;Feminino;131;2;0;129
DIAMANTE;Vereador;Masculino;24;9;0;15
DIAMANTE;Vereador;Feminino;12;0;0;12
DIAMANTE DO NORTE;Vereador;Masculino;36;8;0;28
DIAMANTE DO NORTE;Vereador;Feminino;19;1;0;18
DIAMANTE DO SUL;Vereador;Masculino;33;8;0;25
DIAMANTE DO SUL;Vereador;Feminino;10;1;0;9
DIAMANTE D'OESTE;Vereador;Masculino;23;9;0;14
DIAMANTE D'OESTE;Vereador;Feminino;11;0;0;11
DIAMANTINA;Vereador;Masculino;120;12;0;108
DIAMANTINA;Vereador;Feminino;44;1;0;43
DIAMANTINO;Vereador;Masculino;49;7;0;42
DIAMANTINO;Vereador;Feminino;23;2;0;21
DIANÓPOLIS;Vereador;Masculino;52;8;0;44
DIANÓPOLIS;Vereador;Feminino;27;1;0;26
DIAS D'ÁVILA;Vereador;Masculino;103;13;0;90
DIAS D'ÁVILA;Vereador;Feminino;44;2;0;42
DILERMANDO DE AGUIAR;Vereador;Masculino;22;7;0;15
DILERMANDO DE AGUIAR;Vereador;Feminino;9;2;0;7
DIOGO DE VASCONCELOS;Vereador;Masculino;30;7;0;23
DIOGO DE VASCONCELOS;Vereador;Feminino;16;2;0;14
DIONÍSIO;Vereador;Masculino;52;8;0;44
DIONÍSIO;Vereador;Feminino;30;1;0;29
DIONÍSIO CERQUEIRA;Vereador;Masculino;32;8;0;24
DIONÍSIO CERQUEIRA;Vereador;Feminino;15;1;0;14
DIORAMA;Vereador;Masculino;13;6;0;7
DIORAMA;Vereador;Feminino;6;3;0;3
DIRCE REIS;Vereador;Masculino;24;8;0;16
DIRCE REIS;Vereador;Feminino;12;1;0;11
DIRCEU ARCOVERDE;Vereador;Masculino;18;7;0;11
DIRCEU ARCOVERDE;Vereador;Feminino;9;2;0;7
DIVINA PASTORA;Vereador;Masculino;23;8;0;15
DIVINA PASTORA;Vereador;Feminino;11;1;0;10
DIVINÉSIA;Vereador;Masculino;29;7;0;22
DIVINÉSIA;Vereador;Feminino;17;2;0;15
DIVINO;Vereador;Masculino;35;9;0;26
DIVINO;Vereador;Feminino;18;2;0;16
DIVINO DAS LARANJEIRAS;Vereador;Masculino;30;7;0;23
DIVINO DAS LARANJEIRAS;Vereador;Feminino;15;2;0;13
DIVINO DE SÃO LOURENÇO;Vereador;Masculino;39;8;0;31
DIVINO DE SÃO LOURENÇO;Vereador;Feminino;19;1;0;18
DIVINOLÂNDIA;Vereador;Masculino;33;9;0;24
DIVINOLÂNDIA;Vereador;Feminino;17;0;0;17
DIVINOLÂNDIA DE MINAS;Vereador;Masculino;66;6;0;60
DIVINOLÂNDIA DE MINAS;Vereador;Feminino;30;3;0;27
DIVINÓPOLIS;Vereador;Masculino;238;17;0;221
DIVINÓPOLIS;Vereador;Feminino;112;0;0;112
DIVINÓPOLIS DE GOIÁS;Vereador;Masculino;23;7;0;16
DIVINÓPOLIS DE GOIÁS;Vereador;Feminino;10;2;0;8
DIVINÓPOLIS DO TOCANTINS;Vereador;Masculino;33;7;0;26
DIVINÓPOLIS DO TOCANTINS;Vereador;Feminino;15;2;0;13
DIVISA ALEGRE;Vereador;Masculino;51;9;0;42
DIVISA ALEGRE;Vereador;Feminino;25;0;0;25
DIVISA NOVA;Vereador;Masculino;43;9;0;34
DIVISA NOVA;Vereador;Feminino;21;0;0;21
DIVISÓPOLIS;Vereador;Masculino;21;7;0;14
DIVISÓPOLIS;Vereador;Feminino;10;2;0;8
DOBRADA;Vereador;Masculino;46;7;0;39
DOBRADA;Vereador;Feminino;21;2;0;19
DOIS CÓRREGOS;Vereador;Masculino;60;8;0;52
DOIS CÓRREGOS;Vereador;Feminino;30;1;0;29
DOIS IRMÃOS;Vereador;Masculino;31;8;0;23
DOIS IRMÃOS;Vereador;Feminino;15;1;0;14
DOIS IRMÃOS DAS MISSÕES;Vereador;Masculino;17;8;0;9
DOIS IRMÃOS DAS MISSÕES;Vereador;Feminino;11;1;0;10
DOIS IRMÃOS DO BURITI;Vereador;Masculino;30;8;0;22
DOIS IRMÃOS DO BURITI;Vereador;Feminino;10;1;0;9
DOIS IRMÃOS DO TOCANTINS;Vereador;Masculino;25;8;0;17
DOIS IRMÃOS DO TOCANTINS;Vereador;Feminino;9;1;0;8
DOIS LAJEADOS;Vereador;Masculino;23;8;0;15
DOIS LAJEADOS;Vereador;Feminino;11;1;0;10
DOIS RIACHOS;Vereador;Masculino;20;8;0;12
DOIS RIACHOS;Vereador;Feminino;9;1;0;8
DOIS VIZINHOS;Vereador;Masculino;51;10;0;41
DOIS VIZINHOS;Vereador;Feminino;23;1;0;22
DOLCINÓPOLIS;Vereador;Masculino;26;8;0;18
DOLCINÓPOLIS;Vereador;Feminino;12;1;0;11
DOM AQUINO;Vereador;Masculino;27;5;0;22
DOM AQUINO;Vereador;Feminino;14;4;0;10
DOM BASÍLIO;Vereador;Masculino;47;7;0;40
DOM BASÍLIO;Vereador;Feminino;27;2;0;25
DOM BOSCO;Vereador;Masculino;24;9;0;15
DOM BOSCO;Vereador;Feminino;13;0;0;13
DOM CAVATI;Vereador;Masculino;30;8;0;22
DOM CAVATI;Vereador;Feminino;17;1;0;16
DOM ELISEU;Vereador;Masculino;77;9;0;68
DOM ELISEU;Vereador;Feminino;37;4;0;33
DOM EXPEDITO LOPES;Vereador;Masculino;17;6;0;11
DOM EXPEDITO LOPES;Vereador;Feminino;9;3;0;6
DOM FELICIANO;Vereador;Masculino;38;9;0;29
DOM FELICIANO;Vereador;Feminino;22;0;0;22
DOM INOCÊNCIO;Vereador;Masculino;28;9;0;19
DOM INOCÊNCIO;Vereador;Feminino;14;0;0;14
DOM JOAQUIM;Vereador;Masculino;27;8;0;19
DOM JOAQUIM;Vereador;Feminino;15;1;0;14
DOM MACEDO COSTA;Vereador;Masculino;17;8;0;9
DOM MACEDO COSTA;Vereador;Feminino;8;1;0;7
DOM PEDRITO;Vereador;Masculino;74;12;0;62
DOM PEDRITO;Vereador;Feminino;34;1;0;33
DOM PEDRO;Vereador;Masculino;30;8;0;22
DOM PEDRO;Vereador;Feminino;14;3;0;11
DOM PEDRO DE ALCÂNTARA;Vereador;Masculino;25;9;0;16
DOM PEDRO DE ALCÂNTARA;Vereador;Feminino;12;0;0;12
DOM SILVÉRIO;Vereador;Masculino;30;8;0;22
DOM SILVÉRIO;Vereador;Feminino;14;1;0;13
DOM VIÇOSO;Vereador;Masculino;27;9;0;18
DOM VIÇOSO;Vereador;Feminino;14;0;0;14
DOMINGOS MARTINS;Vereador;Masculino;54;12;0;42
DOMINGOS MARTINS;Vereador;Feminino;25;1;0;24
DOMINGOS MOURÃO;Vereador;Masculino;19;8;0;11
DOMINGOS MOURÃO;Vereador;Feminino;8;1;0;7
DONA EMMA;Vereador;Masculino;21;6;0;15
DONA EMMA;Vereador;Feminino;11;3;0;8
DONA EUSÉBIA;Vereador;Masculino;24;8;0;16
DONA EUSÉBIA;Vereador;Feminino;14;1;0;13
DONA FRANCISCA;Vereador;Masculino;17;8;0;9
DONA FRANCISCA;Vereador;Feminino;8;1;0;7
DONA INÊS;Vereador;Masculino;21;8;0;13
DONA INÊS;Vereador;Feminino;11;1;0;10
DORES DE CAMPOS;Vereador;Masculino;24;9;0;15
DORES DE CAMPOS;Vereador;Feminino;12;0;0;12
DORES DE GUANHÃES;Vereador;Masculino;36;9;0;27
DORES DE GUANHÃES;Vereador;Feminino;17;0;0;17
DORES DO INDAIÁ;Vereador;Masculino;52;9;0;43
DORES DO INDAIÁ;Vereador;Feminino;27;0;0;27
DORES DO RIO PRETO;Vereador;Masculino;30;8;0;22
DORES DO RIO PRETO;Vereador;Feminino;15;1;0;14
DORES DO TURVO;Vereador;Masculino;37;9;0;28
DORES DO TURVO;Vereador;Feminino;17;0;0;17
DORESÓPOLIS;Vereador;Masculino;15;9;0;6
DORESÓPOLIS;Vereador;Feminino;7;0;0;7
DORMENTES;Vereador;Masculino;23;7;0;16
DORMENTES;Vereador;Feminino;12;4;0;8
DOURADINA;Vereador;Masculino;48;18;0;30
DOURADINA;Vereador;Feminino;23;0;0;23
DOURADO;Vereador;Masculino;68;9;0;59
DOURADO;Vereador;Feminino;37;0;0;37
DOURADOQUARA;Vereador;Masculino;27;7;0;20
DOURADOQUARA;Vereador;Feminino;13;2;0;11
DOURADOS;Vereador;Masculino;145;17;0;128
DOURADOS;Vereador;Feminino;73;2;0;71
DOUTOR CAMARGO;Vereador;Masculino;32;7;0;25
DOUTOR CAMARGO;Vereador;Feminino;16;2;0;14
DOUTOR MAURÍCIO CARDOSO;Vereador;Masculino;11;8;0;3
DOUTOR MAURÍCIO CARDOSO;Vereador;Feminino;5;1;0;4
DOUTOR PEDRINHO;Vereador;Masculino;17;5;0;12
DOUTOR PEDRINHO;Vereador;Feminino;8;4;0;4
DOUTOR RICARDO;Vereador;Masculino;16;9;0;7
DOUTOR RICARDO;Vereador;Feminino;8;0;0;8
DOUTOR SEVERIANO;Vereador;Masculino;16;7;0;9
DOUTOR SEVERIANO;Vereador;Feminino;7;2;0;5
DOUTOR ULYSSES;Vereador;Masculino;20;7;0;13
DOUTOR ULYSSES;Vereador;Feminino;8;2;0;6
DOVERLÂNDIA;Vereador;Masculino;35;8;0;27
DOVERLÂNDIA;Vereador;Feminino;16;1;0;15
DRACENA;Vereador;Masculino;76;13;0;63
DRACENA;Vereador;Feminino;34;0;0;34
DUARTINA;Vereador;Masculino;54;7;0;47
DUARTINA;Vereador;Feminino;29;2;0;27
DUAS BARRAS;Vereador;Masculino;29;9;0;20
DUAS BARRAS;Vereador;Feminino;11;0;0;11
DUAS ESTRADAS;Vereador;Masculino;19;8;0;11
DUAS ESTRADAS;Vereador;Feminino;10;1;0;9
DUERÉ;Vereador;Masculino;20;7;0;13
DUERÉ;Vereador;Feminino;11;2;0;9
DUMONT;Vereador;Masculino;47;9;0;38
DUMONT;Vereador;Feminino;24;0;0;24
DUQUE BACELAR;Vereador;Masculino;36;8;0;28
DUQUE BACELAR;Vereador;Feminino;14;1;0;13
DUQUE DE CAXIAS;Vereador;Masculino;524;25;0;499
DUQUE DE CAXIAS;Vereador;Feminino;206;4;0;202
DURANDÉ;Vereador;Masculino;24;7;0;17
DURANDÉ;Vereador;Feminino;11;2;0;9
ECHAPORÃ;Vereador;Masculino;53;7;0;46
ECHAPORÃ;Vereador;Feminino;25;2;0;23
ECOPORANGA;Vereador;Masculino;79;11;0;68
ECOPORANGA;Vereador;Feminino;40;0;0;40
EDEALINA;Vereador;Masculino;30;9;0;21
EDEALINA;Vereador;Feminino;15;0;0;15
EDÉIA;Vereador;Masculino;38;9;0;29
EDÉIA;Vereador;Feminino;12;0;0;12
EIRUNEPÉ;Vereador;Masculino;61;11;0;50
EIRUNEPÉ;Vereador;Feminino;28;0;0;28
ELDORADO;Vereador;Masculino;83;14;0;69
ELDORADO;Vereador;Feminino;47;4;0;43
ELDORADO DO SUL;Vereador;Masculino;69;9;0;60
ELDORADO DO SUL;Vereador;Feminino;39;0;0;39
ELDORADO DOS CARAJÁS;Vereador;Masculino;60;11;0;49
ELDORADO DOS CARAJÁS;Vereador;Feminino;30;2;0;28
ELESBÃO VELOSO;Vereador;Masculino;18;8;0;10
ELESBÃO VELOSO;Vereador;Feminino;8;1;0;7
ELIAS FAUSTO;Vereador;Masculino;94;10;0;84
ELIAS FAUSTO;Vereador;Feminino;46;1;0;45
ELISEU MARTINS;Vereador;Masculino;27;8;0;19
ELISEU MARTINS;Vereador;Feminino;13;1;0;12
ELISIÁRIO;Vereador;Masculino;19;6;0;13
ELISIÁRIO;Vereador;Feminino;9;3;0;6
ELÍSIO MEDRADO;Vereador;Masculino;24;8;0;16
ELÍSIO MEDRADO;Vereador;Feminino;12;1;0;11
ELÓI MENDES;Vereador;Masculino;46;9;0;37
ELÓI MENDES;Vereador;Feminino;26;2;0;24
EMAS;Vereador;Masculino;20;8;0;12
EMAS;Vereador;Feminino;10;1;0;9
EMBAÚBA;Vereador;Masculino;25;7;0;18
EMBAÚBA;Vereador;Feminino;15;2;0;13
EMBU DAS ARTES;Vereador;Masculino;146;13;0;133
EMBU DAS ARTES;Vereador;Feminino;64;2;0;62
EMBU-GUAÇU;Vereador;Masculino;136;9;0;127
EMBU-GUAÇU;Vereador;Feminino;60;1;0;59
EMILIANÓPOLIS;Vereador;Masculino;29;7;0;22
EMILIANÓPOLIS;Vereador;Feminino;15;2;0;13
ENCANTADO;Vereador;Masculino;33;10;0;23
ENCANTADO;Vereador;Feminino;15;1;0;14
ENCANTO;Vereador;Masculino;18;6;0;12
ENCANTO;Vereador;Feminino;10;3;0;7
ENCRUZILHADA;Vereador;Masculino;44;9;0;35
ENCRUZILHADA;Vereador;Feminino;18;2;0;16
ENCRUZILHADA DO SUL;Vereador;Masculino;47;10;0;37
ENCRUZILHADA DO SUL;Vereador;Feminino;22;1;0;21
ENÉAS MARQUES;Vereador;Masculino;23;9;0;14
ENÉAS MARQUES;Vereador;Feminino;10;0;0;10
ENGENHEIRO BELTRÃO;Vereador;Masculino;51;8;0;43
ENGENHEIRO BELTRÃO;Vereador;Feminino;26;1;0;25
ENGENHEIRO CALDAS;Vereador;Masculino;35;5;0;30
ENGENHEIRO CALDAS;Vereador;Feminino;16;4;0;12
ENGENHEIRO COELHO;Vereador;Masculino;58;11;0;47
ENGENHEIRO COELHO;Vereador;Feminino;28;0;0;28
ENGENHEIRO NAVARRO;Vereador;Masculino;34;9;0;25
ENGENHEIRO NAVARRO;Vereador;Feminino;17;0;0;17
ENGENHEIRO PAULO DE FRONTIN;Vereador;Masculino;78;8;0;70
ENGENHEIRO PAULO DE FRONTIN;Vereador;Feminino;40;1;0;39
ENGENHO VELHO;Vereador;Masculino;17;8;0;9
ENGENHO VELHO;Vereador;Feminino;8;1;0;7
ENTRE FOLHAS;Vereador;Masculino;39;8;0;31
ENTRE FOLHAS;Vereador;Feminino;17;1;0;16
ENTRE RIOS;Vereador;Masculino;90;17;0;73
ENTRE RIOS;Vereador;Feminino;49;1;0;48
ENTRE RIOS DE MINAS;Vereador;Masculino;63;9;0;54
ENTRE RIOS DE MINAS;Vereador;Feminino;33;0;0;33
ENTRE RIOS DO OESTE;Vereador;Masculino;20;7;0;13
ENTRE RIOS DO OESTE;Vereador;Feminino;9;2;0;7
ENTRE RIOS DO SUL;Vereador;Masculino;22;8;0;14
ENTRE RIOS DO SUL;Vereador;Feminino;11;1;0;10
ENTRE-IJUÍS;Vereador;Masculino;31;9;0;22
ENTRE-IJUÍS;Vereador;Feminino;15;0;0;15
ENVIRA;Vereador;Masculino;52;10;0;42
ENVIRA;Vereador;Feminino;23;1;0;22
EPITACIOLÂNDIA;Vereador;Masculino;66;9;0;57
EPITACIOLÂNDIA;Vereador;Feminino;35;0;0;35
EQUADOR;Vereador;Masculino;23;9;0;14
EQUADOR;Vereador;Feminino;6;0;0;6
EREBANGO;Vereador;Masculino;21;9;0;12
EREBANGO;Vereador;Feminino;8;0;0;8
ERECHIM;Vereador;Masculino;120;15;0;105
ERECHIM;Vereador;Feminino;55;2;0;53
ERERÊ;Vereador;Masculino;18;7;0;11
ERERÊ;Vereador;Feminino;12;2;0;10
ÉRICO CARDOSO;Vereador;Masculino;24;9;0;15
ÉRICO CARDOSO;Vereador;Feminino;11;0;0;11
ERMO;Vereador;Masculino;26;9;0;17
ERMO;Vereador;Feminino;13;0;0;13
ERNESTINA;Vereador;Masculino;20;8;0;12
ERNESTINA;Vereador;Feminino;10;1;0;9
ERVAL GRANDE;Vereador;Masculino;14;8;0;6
ERVAL GRANDE;Vereador;Feminino;8;1;0;7
ERVAL SECO;Vereador;Masculino;34;6;0;28
ERVAL SECO;Vereador;Feminino;17;3;0;14
ERVAL VELHO;Vereador;Masculino;20;7;0;13
ERVAL VELHO;Vereador;Feminino;10;2;0;8
ERVÁLIA;Vereador;Masculino;43;10;0;33
ERVÁLIA;Vereador;Feminino;20;1;0;19
ESCADA;Vereador;Masculino;124;12;0;112
ESCADA;Vereador;Feminino;51;1;0;50
ESMERALDA;Vereador;Masculino;20;9;0;11
ESMERALDA;Vereador;Feminino;7;0;0;7
ESMERALDAS;Vereador;Masculino;103;9;0;94
ESMERALDAS;Vereador;Feminino;49;2;0;47
ESPERA FELIZ;Vereador;Masculino;51;10;0;41
ESPERA FELIZ;Vereador;Feminino;29;1;0;28
ESPERANÇA;Vereador;Masculino;63;12;0;51
ESPERANÇA;Vereador;Feminino;23;1;0;22
ESPERANÇA DO SUL;Vereador;Masculino;20;7;0;13
ESPERANÇA DO SUL;Vereador;Feminino;10;2;0;8
ESPERANÇA NOVA;Vereador;Masculino;23;8;0;15
ESPERANÇA NOVA;Vereador;Feminino;11;1;0;10
ESPERANTINA;Vereador;Masculino;110;20;0;90
ESPERANTINA;Vereador;Feminino;56;2;0;54
ESPERANTINÓPOLIS;Vereador;Masculino;32;10;0;22
ESPERANTINÓPOLIS;Vereador;Feminino;15;1;0;14
ESPIGÃO ALTO DO IGUAÇU;Vereador;Masculino;24;9;0;15
ESPIGÃO ALTO DO IGUAÇU;Vereador;Feminino;12;0;0;12
ESPIGÃO DO OESTE;Vereador;Masculino;73;11;0;62
ESPIGÃO DO OESTE;Vereador;Feminino;30;0;0;30
ESPINOSA;Vereador;Masculino;44;12;0;32
ESPINOSA;Vereador;Feminino;20;1;0;19
ESPÍRITO SANTO;Vereador;Masculino;16;5;0;11
ESPÍRITO SANTO;Vereador;Feminino;11;4;0;7
ESPÍRITO SANTO DO DOURADO;Vereador;Masculino;34;7;0;27
ESPÍRITO SANTO DO DOURADO;Vereador;Feminino;16;2;0;14
ESPÍRITO SANTO DO PINHAL;Vereador;Masculino;53;7;0;46
ESPÍRITO SANTO DO PINHAL;Vereador;Feminino;29;2;0;27
ESPÍRITO SANTO DO TURVO;Vereador;Masculino;24;8;0;16
ESPÍRITO SANTO DO TURVO;Vereador;Feminino;13;1;0;12
ESPLANADA;Vereador;Masculino;102;11;0;91
ESPLANADA;Vereador;Feminino;35;2;0;33
ESPUMOSO;Vereador;Masculino;35;8;0;27
ESPUMOSO;Vereador;Feminino;18;1;0;17
ESTAÇÃO;Vereador;Masculino;27;9;0;18
ESTAÇÃO;Vereador;Feminino;13;0;0;13
ESTÂNCIA;Vereador;Masculino;103;12;0;91
ESTÂNCIA;Vereador;Feminino;46;0;0;46
ESTÂNCIA VELHA;Vereador;Masculino;53;7;0;46
ESTÂNCIA VELHA;Vereador;Feminino;24;2;0;22
ESTEIO;Vereador;Masculino;80;7;0;73
ESTEIO;Vereador;Feminino;37;3;0;34
ESTIVA;Vereador;Masculino;25;7;0;18
ESTIVA;Vereador;Feminino;12;2;0;10
ESTIVA GERBI;Vereador;Masculino;83;8;0;75
ESTIVA GERBI;Vereador;Feminino;41;1;0;40
ESTREITO;Vereador;Masculino;98;8;0;90
ESTREITO;Vereador;Feminino;49;5;0;44
ESTRELA;Vereador;Masculino;71;12;0;59
ESTRELA;Vereador;Feminino;34;1;0;33
ESTRELA DALVA;Vereador;Masculino;20;8;0;12
ESTRELA DALVA;Vereador;Feminino;10;1;0;9
ESTRELA DE ALAGOAS;Vereador;Masculino;33;9;0;24
ESTRELA DE ALAGOAS;Vereador;Feminino;15;2;0;13
ESTRELA DO INDAIÁ;Vereador;Masculino;14;7;0;7
ESTRELA DO INDAIÁ;Vereador;Feminino;7;2;0;5
ESTRELA DO NORTE;Vereador;Masculino;63;16;0;47
ESTRELA DO NORTE;Vereador;Feminino;31;2;0;29
ESTRELA DO SUL;Vereador;Masculino;31;8;0;23
ESTRELA DO SUL;Vereador;Feminino;15;1;0;14
ESTRELA D'OESTE;Vereador;Masculino;30;8;0;22
ESTRELA D'OESTE;Vereador;Feminino;14;1;0;13
ESTRELA VELHA;Vereador;Masculino;23;6;0;17
ESTRELA VELHA;Vereador;Feminino;11;3;0;8
EUCLIDES DA CUNHA;Vereador;Masculino;37;13;0;24
EUCLIDES DA CUNHA;Vereador;Feminino;14;2;0;12
EUCLIDES DA CUNHA PAULISTA;Vereador;Masculino;48;6;0;42
EUCLIDES DA CUNHA PAULISTA;Vereador;Feminino;25;3;0;22
EUGÊNIO DE CASTRO;Vereador;Masculino;18;6;0;12
EUGÊNIO DE CASTRO;Vereador;Feminino;10;3;0;7
EUGENÓPOLIS;Vereador;Masculino;30;9;0;21
EUGENÓPOLIS;Vereador;Feminino;15;0;0;15
EUNÁPOLIS;Vereador;Masculino;117;17;0;100
EUNÁPOLIS;Vereador;Feminino;52;0;0;52
EUSÉBIO;Vereador;Masculino;72;9;0;63
EUSÉBIO;Vereador;Feminino;39;4;0;35
EWBANK DA CÂMARA;Vereador;Masculino;42;7;0;35
EWBANK DA CÂMARA;Vereador;Feminino;21;2;0;19
EXTREMA;Vereador;Masculino;62;11;0;51
EXTREMA;Vereador;Feminino;29;0;0;29
EXTREMOZ;Vereador;Masculino;58;9;0;49
EXTREMOZ;Vereador;Feminino;26;2;0;24
EXU;Vereador;Masculino;27;12;0;15
EXU;Vereador;Feminino;13;1;0;12
FAGUNDES;Vereador;Masculino;32;9;0;23
FAGUNDES;Vereador;Feminino;16;0;0;16
FAGUNDES VARELA;Vereador;Masculino;13;8;0;5
FAGUNDES VARELA;Vereador;Feminino;7;1;0;6
FAINA;Vereador;Masculino;53;8;0;45
FAINA;Vereador;Feminino;28;1;0;27
FAMA;Vereador;Masculino;31;8;0;23
FAMA;Vereador;Feminino;17;1;0;16
FARIA LEMOS;Vereador;Masculino;36;9;0;27
FARIA LEMOS;Vereador;Feminino;17;0;0;17
FARIAS BRITO;Vereador;Masculino;18;9;0;9
FARIAS BRITO;Vereador;Feminino;9;2;0;7
FARO;Vereador;Masculino;48;8;0;40
FARO;Vereador;Feminino;23;1;0;22
FAROL;Vereador;Masculino;29;9;0;20
FAROL;Vereador;Feminino;13;0;0;13
FARROUPILHA;Vereador;Masculino;94;13;0;81
FARROUPILHA;Vereador;Feminino;38;2;0;36
FARTURA;Vereador;Masculino;47;8;0;39
FARTURA;Vereador;Feminino;23;1;0;22
FARTURA DO PIAUÍ;Vereador;Masculino;22;9;0;13
FARTURA DO PIAUÍ;Vereador;Feminino;12;0;0;12
FÁTIMA;Vereador;Masculino;43;18;0;25
FÁTIMA;Vereador;Feminino;18;2;0;16
FÁTIMA DO SUL;Vereador;Masculino;43;10;0;33
FÁTIMA DO SUL;Vereador;Feminino;17;1;0;16
FAXINAL;Vereador;Masculino;19;9;0;10
FAXINAL;Vereador;Feminino;8;0;0;8
FAXINAL DO SOTURNO;Vereador;Masculino;26;7;0;19
FAXINAL DO SOTURNO;Vereador;Feminino;13;2;0;11
FAXINAL DOS GUEDES;Vereador;Masculino;22;8;0;14
FAXINAL DOS GUEDES;Vereador;Feminino;13;1;0;12
FAXINALZINHO;Vereador;Masculino;21;8;0;13
FAXINALZINHO;Vereador;Feminino;11;1;0;10
FAZENDA NOVA;Vereador;Masculino;24;8;0;16
FAZENDA NOVA;Vereador;Feminino;14;1;0;13
FAZENDA RIO GRANDE;Vereador;Masculino;149;13;0;136
FAZENDA RIO GRANDE;Vereador;Feminino;69;0;0;69
FAZENDA VILANOVA;Vereador;Masculino;24;9;0;15
FAZENDA VILANOVA;Vereador;Feminino;12;0;0;12
FEIJÓ;Vereador;Masculino;63;12;0;51
FEIJÓ;Vereador;Feminino;30;1;0;29
FEIRA DA MATA;Vereador;Masculino;16;7;0;9
FEIRA DA MATA;Vereador;Feminino;8;2;0;6
FEIRA DE SANTANA;Vereador;Masculino;288;17;0;271
FEIRA DE SANTANA;Vereador;Feminino;100;4;0;96
FEIRA GRANDE;Vereador;Masculino;31;11;0;20
FEIRA GRANDE;Vereador;Feminino;19;0;0;19
FEIRA NOVA;Vereador;Masculino;87;18;0;69
FEIRA NOVA;Vereador;Feminino;42;2;0;40
FEIRA NOVA DO MARANHÃO;Vereador;Masculino;21;7;0;14
FEIRA NOVA DO MARANHÃO;Vereador;Feminino;10;2;0;8
FELÍCIO DOS SANTOS;Vereador;Masculino;31;8;0;23
FELÍCIO DOS SANTOS;Vereador;Feminino;18;1;0;17
FELIPE GUERRA;Vereador;Masculino;21;8;0;13
FELIPE GUERRA;Vereador;Feminino;7;1;0;6
FELISBURGO;Vereador;Masculino;25;7;0;18
FELISBURGO;Vereador;Feminino;13;2;0;11
FELIXLÂNDIA;Vereador;Masculino;48;7;0;41
FELIXLÂNDIA;Vereador;Feminino;22;2;0;20
FELIZ;Vereador;Masculino;35;9;0;26
FELIZ;Vereador;Feminino;18;0;0;18
FELIZ DESERTO;Vereador;Masculino;25;7;0;18
FELIZ DESERTO;Vereador;Feminino;16;2;0;14
FELIZ NATAL;Vereador;Masculino;30;7;0;23
FELIZ NATAL;Vereador;Feminino;17;2;0;15
FÊNIX;Vereador;Masculino;27;9;0;18
FÊNIX;Vereador;Feminino;15;0;0;15
FERNANDES PINHEIRO;Vereador;Masculino;54;7;0;47
FERNANDES PINHEIRO;Vereador;Feminino;28;2;0;26
FERNANDES TOURINHO;Vereador;Masculino;20;8;0;12
FERNANDES TOURINHO;Vereador;Feminino;10;1;0;9
FERNANDO FALCÃO;Vereador;Masculino;32;7;0;25
FERNANDO FALCÃO;Vereador;Feminino;10;2;0;8
FERNANDO PEDROZA;Vereador;Masculino;27;9;0;18
FERNANDO PEDROZA;Vereador;Feminino;13;0;0;13
FERNANDO PRESTES;Vereador;Masculino;23;8;0;15
FERNANDO PRESTES;Vereador;Feminino;12;1;0;11
FERNANDÓPOLIS;Vereador;Masculino;102;12;0;90
FERNANDÓPOLIS;Vereador;Feminino;47;1;0;46
FERNÃO;Vereador;Masculino;23;9;0;14
FERNÃO;Vereador;Feminino;11;0;0;11
FERRAZ DE VASCONCELOS;Vereador;Masculino;246;15;0;231
FERRAZ DE VASCONCELOS;Vereador;Feminino;106;2;0;104
FERREIRA GOMES;Vereador;Masculino;49;6;0;43
FERREIRA GOMES;Vereador;Feminino;23;3;0;20
FERREIROS;Vereador;Masculino;24;8;0;16
FERREIROS;Vereador;Feminino;10;1;0;9
FERROS;Vereador;Masculino;40;8;0;32
FERROS;Vereador;Feminino;25;1;0;24
FERVEDOURO;Vereador;Masculino;47;7;0;40
FERVEDOURO;Vereador;Feminino;22;2;0;20
FIGUEIRA;Vereador;Masculino;54;7;0;47
FIGUEIRA;Vereador;Feminino;21;2;0;19
FIGUEIRÃO;Vereador;Masculino;20;8;0;12
FIGUEIRÃO;Vereador;Feminino;10;1;0;9
FIGUEIRÓPOLIS;Vereador;Masculino;19;7;0;12
FIGUEIRÓPOLIS;Vereador;Feminino;10;2;0;8
FIGUEIRÓPOLIS D'OESTE;Vereador;Masculino;20;8;0;12
FIGUEIRÓPOLIS D'OESTE;Vereador;Feminino;10;1;0;9
FILADÉLFIA;Vereador;Masculino;61;19;0;42
FILADÉLFIA;Vereador;Feminino;26;1;0;25
FIRMINO ALVES;Vereador;Masculino;21;8;0;13
FIRMINO ALVES;Vereador;Feminino;10;1;0;9
FIRMINÓPOLIS;Vereador;Masculino;36;7;0;29
FIRMINÓPOLIS;Vereador;Feminino;19;2;0;17
FLEXEIRAS;Vereador;Masculino;38;8;0;30
FLEXEIRAS;Vereador;Feminino;20;1;0;19
FLOR DA SERRA DO SUL;Vereador;Masculino;21;7;0;14
FLOR DA SERRA DO SUL;Vereador;Feminino;8;2;0;6
FLOR DO SERTÃO;Vereador;Masculino;13;7;0;6
FLOR DO SERTÃO;Vereador;Feminino;7;2;0;5
FLORA RICA;Vereador;Masculino;30;7;0;23
FLORA RICA;Vereador;Feminino;18;2;0;16
FLORAÍ;Vereador;Masculino;33;8;0;25
FLORAÍ;Vereador;Feminino;17;1;0;16
FLORÂNIA;Vereador;Masculino;29;8;0;21
FLORÂNIA;Vereador;Feminino;14;1;0;13
FLOREAL;Vereador;Masculino;26;8;0;18
FLOREAL;Vereador;Feminino;12;1;0;11
FLORES;Vereador;Masculino;32;9;0;23
FLORES;Vereador;Feminino;12;1;0;11
FLORES DA CUNHA;Vereador;Masculino;53;8;0;45
FLORES DA CUNHA;Vereador;Feminino;18;1;0;17
FLORES DE GOIÁS;Vereador;Masculino;51;9;0;42
FLORES DE GOIÁS;Vereador;Feminino;23;0;0;23
FLORES DO PIAUÍ;Vereador;Masculino;19;8;0;11
FLORES DO PIAUÍ;Vereador;Feminino;9;1;0;8
FLORESTA;Vereador;Masculino;85;19;0;66
FLORESTA;Vereador;Feminino;43;1;0;42
FLORESTA AZUL;Vereador;Masculino;43;8;0;35
FLORESTA AZUL;Vereador;Feminino;15;1;0;14
FLORESTA DO ARAGUAIA;Vereador;Masculino;54;10;0;44
FLORESTA DO ARAGUAIA;Vereador;Feminino;27;1;0;26
FLORESTA DO PIAUÍ;Vereador;Masculino;18;7;0;11
FLORESTA DO PIAUÍ;Vereador;Feminino;9;2;0;7
FLORESTAL;Vereador;Masculino;39;7;0;32
FLORESTAL;Vereador;Feminino;21;2;0;19
FLORESTÓPOLIS;Vereador;Masculino;44;9;0;35
FLORESTÓPOLIS;Vereador;Feminino;13;0;0;13
FLORIANO;Vereador;Masculino;92;13;0;79
FLORIANO;Vereador;Feminino;37;1;0;36
FLORIANO PEIXOTO;Vereador;Masculino;17;8;0;9
FLORIANO PEIXOTO;Vereador;Feminino;9;1;0;8
FLORIANÓPOLIS;Vereador;Masculino;231;23;0;208
FLORIANÓPOLIS;Vereador;Feminino;104;0;0;104
FLÓRIDA;Vereador;Masculino;19;7;0;12
FLÓRIDA;Vereador;Feminino;9;2;0;7
FLÓRIDA PAULISTA;Vereador;Masculino;43;8;0;35
FLÓRIDA PAULISTA;Vereador;Feminino;22;1;0;21
FLORÍNEA;Vereador;Masculino;23;9;0;14
FLORÍNEA;Vereador;Feminino;12;0;0;12
FONTE BOA;Vereador;Masculino;61;10;0;51
FONTE BOA;Vereador;Feminino;27;1;0;26
FONTOURA XAVIER;Vereador;Masculino;24;5;0;19
FONTOURA XAVIER;Vereador;Feminino;12;4;0;8
FORMIGA;Vereador;Masculino;93;9;0;84
FORMIGA;Vereador;Feminino;41;1;0;40
FORMIGUEIRO;Vereador;Masculino;26;8;0;18
FORMIGUEIRO;Vereador;Feminino;13;1;0;12
FORMOSA;Vereador;Masculino;130;17;0;113
FORMOSA;Vereador;Feminino;58;0;0;58
FORMOSA DA SERRA NEGRA;Vereador;Masculino;27;9;0;18
FORMOSA DA SERRA NEGRA;Vereador;Feminino;11;2;0;9
FORMOSA DO OESTE;Vereador;Masculino;27;7;0;20
FORMOSA DO OESTE;Vereador;Feminino;14;2;0;12
FORMOSA DO RIO PRETO;Vereador;Masculino;39;10;0;29
FORMOSA DO RIO PRETO;Vereador;Feminino;21;1;0;20
FORMOSA DO SUL;Vereador;Masculino;17;7;0;10
FORMOSA DO SUL;Vereador;Feminino;11;2;0;9
FORMOSO;Vereador;Masculino;61;15;0;46
FORMOSO;Vereador;Feminino;31;3;0;28
FORMOSO DO ARAGUAIA;Vereador;Masculino;61;8;0;53
FORMOSO DO ARAGUAIA;Vereador;Feminino;28;3;0;25
FORQUETINHA;Vereador;Masculino;21;7;0;14
FORQUETINHA;Vereador;Feminino;10;2;0;8
FORQUILHA;Vereador;Masculino;30;7;0;23
FORQUILHA;Vereador;Feminino;18;4;0;14
FORQUILHINHA;Vereador;Masculino;42;8;0;34
FORQUILHINHA;Vereador;Feminino;22;1;0;21
FORTALEZA;Vereador;Masculino;721;36;0;685
FORTALEZA;Vereador;Feminino;303;7;0;296
FORTALEZA DE MINAS;Vereador;Masculino;30;9;0;21
FORTALEZA DE MINAS;Vereador;Feminino;14;0;0;14
FORTALEZA DO TABOCÃO;Vereador;Masculino;19;8;0;11
FORTALEZA DO TABOCÃO;Vereador;Feminino;10;1;0;9
FORTALEZA DOS NOGUEIRAS;Vereador;Masculino;27;7;0;20
FORTALEZA DOS NOGUEIRAS;Vereador;Feminino;13;2;0;11
FORTALEZA DOS VALOS;Vereador;Masculino;18;6;0;12
FORTALEZA DOS VALOS;Vereador;Feminino;8;3;0;5
FORTIM;Vereador;Masculino;20;4;0;16
FORTIM;Vereador;Feminino;12;5;0;7
FORTUNA;Vereador;Masculino;24;10;0;14
FORTUNA;Vereador;Feminino;11;1;0;10
FORTUNA DE MINAS;Vereador;Masculino;39;7;0;32
FORTUNA DE MINAS;Vereador;Feminino;21;2;0;19
FOZ DO IGUAÇU;Vereador;Masculino;149;14;0;135
FOZ DO IGUAÇU;Vereador;Feminino;60;1;0;59
FOZ DO JORDÃO;Vereador;Masculino;39;9;0;30
FOZ DO JORDÃO;Vereador;Feminino;9;0;0;9
FRAIBURGO;Vereador;Masculino;76;11;0;65
FRAIBURGO;Vereador;Feminino;33;0;0;33
FRANCA;Vereador;Masculino;194;14;0;180
FRANCA;Vereador;Feminino;80;1;0;79
FRANCINÓPOLIS;Vereador;Masculino;19;6;0;13
FRANCINÓPOLIS;Vereador;Feminino;11;3;0;8
FRANCISCO ALVES;Vereador;Masculino;23;8;0;15
FRANCISCO ALVES;Vereador;Feminino;12;1;0;11
FRANCISCO AYRES;Vereador;Masculino;21;7;0;14
FRANCISCO AYRES;Vereador;Feminino;10;2;0;8
FRANCISCO BADARÓ;Vereador;Masculino;31;9;0;22
FRANCISCO BADARÓ;Vereador;Feminino;15;0;0;15
FRANCISCO BELTRÃO;Vereador;Masculino;63;7;0;56
FRANCISCO BELTRÃO;Vereador;Feminino;29;3;0;26
FRANCISCO DANTAS;Vereador;Masculino;17;8;0;9
FRANCISCO DANTAS;Vereador;Feminino;7;1;0;6
FRANCISCO DUMONT;Vereador;Masculino;47;9;0;38
FRANCISCO DUMONT;Vereador;Feminino;25;0;0;25
FRANCISCO MACEDO;Vereador;Masculino;11;8;0;3
FRANCISCO MACEDO;Vereador;Feminino;5;1;0;4
FRANCISCO MORATO;Vereador;Masculino;159;11;0;148
FRANCISCO MORATO;Vereador;Feminino;77;1;0;76
FRANCISCO SÁ;Vereador;Masculino;57;9;0;48
FRANCISCO SÁ;Vereador;Feminino;28;2;0;26
FRANCISCO SANTOS;Vereador;Masculino;16;8;0;8
FRANCISCO SANTOS;Vereador;Feminino;8;1;0;7
FRANCISCÓPOLIS;Vereador;Masculino;39;8;0;31
FRANCISCÓPOLIS;Vereador;Feminino;19;1;0;18
FRANCO DA ROCHA;Vereador;Masculino;139;10;0;129
FRANCO DA ROCHA;Vereador;Feminino;61;1;0;60
FRECHEIRINHA;Vereador;Masculino;19;7;0;12
FRECHEIRINHA;Vereador;Feminino;9;2;0;7
FREDERICO WESTPHALEN;Vereador;Masculino;28;10;0;18
FREDERICO WESTPHALEN;Vereador;Feminino;13;1;0;12
FREI GASPAR;Vereador;Masculino;33;9;0;24
FREI GASPAR;Vereador;Feminino;15;0;0;15
FREI INOCÊNCIO;Vereador;Masculino;78;8;0;70
FREI INOCÊNCIO;Vereador;Feminino;35;1;0;34
FREI LAGONEGRO;Vereador;Masculino;22;9;0;13
FREI LAGONEGRO;Vereador;Feminino;11;0;0;11
FREI MARTINHO;Vereador;Masculino;18;8;0;10
FREI MARTINHO;Vereador;Feminino;8;1;0;7
FREI MIGUELINHO;Vereador;Masculino;38;9;0;29
FREI MIGUELINHO;Vereador;Feminino;8;0;0;8
FREI PAULO;Vereador;Masculino;31;7;0;24
FREI PAULO;Vereador;Feminino;13;2;0;11
FREI ROGÉRIO;Vereador;Masculino;18;7;0;11
FREI ROGÉRIO;Vereador;Feminino;11;2;0;9
FRONTEIRA;Vereador;Masculino;61;6;0;55
FRONTEIRA;Vereador;Feminino;29;3;0;26
FRONTEIRA DOS VALES;Vereador;Masculino;33;8;0;25
FRONTEIRA DOS VALES;Vereador;Feminino;16;1;0;15
FRONTEIRAS;Vereador;Masculino;17;3;0;14
FRONTEIRAS;Vereador;Feminino;11;6;0;5
FRUTA DE LEITE;Vereador;Masculino;25;9;0;16
FRUTA DE LEITE;Vereador;Feminino;14;0;0;14
FRUTAL;Vereador;Masculino;89;13;0;76
FRUTAL;Vereador;Feminino;45;2;0;43
FRUTUOSO GOMES;Vereador;Masculino;20;8;0;12
FRUTUOSO GOMES;Vereador;Feminino;9;1;0;8
FUNDÃO;Vereador;Masculino;63;9;0;54
FUNDÃO;Vereador;Feminino;31;2;0;29
FUNILÂNDIA;Vereador;Masculino;54;7;0;47
FUNILÂNDIA;Vereador;Feminino;25;2;0;23
GABRIEL MONTEIRO;Vereador;Masculino;18;7;0;11
GABRIEL MONTEIRO;Vereador;Feminino;11;2;0;9
GADO BRAVO;Vereador;Masculino;36;8;0;28
GADO BRAVO;Vereador;Feminino;18;1;0;17
GÁLIA;Vereador;Masculino;40;7;0;33
GÁLIA;Vereador;Feminino;21;2;0;19
GALILÉIA;Vereador;Masculino;42;8;0;34
GALILÉIA;Vereador;Feminino;20;1;0;19
GALINHOS;Vereador;Masculino;25;6;0;19
GALINHOS;Vereador;Feminino;12;3;0;9
GALVÃO;Vereador;Masculino;24;9;0;15
GALVÃO;Vereador;Feminino;12;0;0;12
GAMELEIRA;Vereador;Masculino;70;7;0;63
GAMELEIRA;Vereador;Feminino;34;2;0;32
GAMELEIRA DE GOIÁS;Vereador;Masculino;44;7;0;37
GAMELEIRA DE GOIÁS;Vereador;Feminino;22;2;0;20
GAMELEIRAS;Vereador;Masculino;13;7;0;6
GAMELEIRAS;Vereador;Feminino;7;2;0;5
GANDU;Vereador;Masculino;88;12;0;76
GANDU;Vereador;Feminino;43;1;0;42
GARANHUNS;Vereador;Masculino;79;10;0;69
GARANHUNS;Vereador;Feminino;34;3;0;31
GARARU;Vereador;Masculino;23;8;0;15
GARARU;Vereador;Feminino;11;1;0;10
GARÇA;Vereador;Masculino;110;12;0;98
GARÇA;Vereador;Feminino;53;1;0;52
GARIBALDI;Vereador;Masculino;44;9;0;35
GARIBALDI;Vereador;Feminino;23;0;0;23
GAROPABA;Vereador;Masculino;33;9;0;24
GAROPABA;Vereador;Feminino;17;0;0;17
GARRAFÃO DO NORTE;Vereador;Masculino;49;10;0;39
GARRAFÃO DO NORTE;Vereador;Feminino;26;1;0;25
GARRUCHOS;Vereador;Masculino;15;8;0;7
GARRUCHOS;Vereador;Feminino;7;1;0;6
GARUVA;Vereador;Masculino;43;6;0;37
GARUVA;Vereador;Feminino;22;3;0;19
GASPAR;Vereador;Masculino;79;10;0;69
GASPAR;Vereador;Feminino;35;3;0;32
GASTÃO VIDIGAL;Vereador;Masculino;34;7;0;27
GASTÃO VIDIGAL;Vereador;Feminino;18;2;0;16
GAÚCHA DO NORTE;Vereador;Masculino;16;8;0;8
GAÚCHA DO NORTE;Vereador;Feminino;6;1;0;5
GAURAMA;Vereador;Masculino;17;8;0;9
GAURAMA;Vereador;Feminino;8;1;0;7
GAVIÃO;Vereador;Masculino;32;8;0;24
GAVIÃO;Vereador;Feminino;15;1;0;14
GAVIÃO PEIXOTO;Vereador;Masculino;42;7;0;35
GAVIÃO PEIXOTO;Vereador;Feminino;21;2;0;19
GEMINIANO;Vereador;Masculino;24;6;0;18
GEMINIANO;Vereador;Feminino;12;3;0;9
GENERAL CÂMARA;Vereador;Masculino;23;9;0;14
GENERAL CÂMARA;Vereador;Feminino;11;0;0;11
GENERAL CARNEIRO;Vereador;Masculino;95;16;0;79
GENERAL CARNEIRO;Vereador;Feminino;35;2;0;33
GENERAL MAYNARD;Vereador;Masculino;23;9;0;14
GENERAL MAYNARD;Vereador;Feminino;11;0;0;11
GENERAL SALGADO;Vereador;Masculino;52;9;0;43
GENERAL SALGADO;Vereador;Feminino;25;0;0;25
GENERAL SAMPAIO;Vereador;Masculino;35;7;0;28
GENERAL SAMPAIO;Vereador;Feminino;15;2;0;13
GENTIL;Vereador;Masculino;7;5;0;2
GENTIL;Vereador;Feminino;5;4;0;1
GENTIO DO OURO;Vereador;Masculino;23;9;0;14
GENTIO DO OURO;Vereador;Feminino;12;0;0;12
GETULINA;Vereador;Masculino;49;7;0;42
GETULINA;Vereador;Feminino;25;2;0;23
GETÚLIO VARGAS;Vereador;Masculino;28;9;0;19
GETÚLIO VARGAS;Vereador;Feminino;16;0;0;16
GILBUÉS;Vereador;Masculino;19;8;0;11
GILBUÉS;Vereador;Feminino;11;1;0;10
GIRAU DO PONCIANO;Vereador;Masculino;32;9;0;23
GIRAU DO PONCIANO;Vereador;Feminino;17;0;0;17
GIRUÁ;Vereador;Masculino;29;10;0;19
GIRUÁ;Vereador;Feminino;20;1;0;19
GLAUCILÂNDIA;Vereador;Masculino;34;9;0;25
GLAUCILÂNDIA;Vereador;Feminino;14;0;0;14
GLICÉRIO;Vereador;Masculino;38;7;0;31
GLICÉRIO;Vereador;Feminino;21;2;0;19
GLÓRIA;Vereador;Masculino;23;11;0;12
GLÓRIA;Vereador;Feminino;11;0;0;11
GLÓRIA DE DOURADOS;Vereador;Masculino;46;7;0;39
GLÓRIA DE DOURADOS;Vereador;Feminino;28;2;0;26
GLÓRIA DO GOITÁ;Vereador;Masculino;54;9;0;45
GLÓRIA DO GOITÁ;Vereador;Feminino;12;1;0;11
GLÓRIA D'OESTE;Vereador;Masculino;26;9;0;17
GLÓRIA D'OESTE;Vereador;Feminino;13;0;0;13
GLORINHA;Vereador;Masculino;22;9;0;13
GLORINHA;Vereador;Feminino;11;0;0;11
GODOFREDO VIANA;Vereador;Masculino;30;9;0;21
GODOFREDO VIANA;Vereador;Feminino;18;0;0;18
GODOY MOREIRA;Vereador;Masculino;26;9;0;17
GODOY MOREIRA;Vereador;Feminino;13;0;0;13
GOIABEIRA;Vereador;Masculino;23;9;0;14
GOIABEIRA;Vereador;Feminino;13;0;0;13
GOIANA;Vereador;Masculino;141;10;0;131
GOIANA;Vereador;Feminino;52;5;0;47
GOIANÁ;Vereador;Masculino;31;9;0;22
GOIANÁ;Vereador;Feminino;15;0;0;15
GOIANÁPOLIS;Vereador;Masculino;66;8;0;58
GOIANÁPOLIS;Vereador;Feminino;34;1;0;33
GOIANDIRA;Vereador;Masculino;26;8;0;18
GOIANDIRA;Vereador;Feminino;12;1;0;11
GOIANÉSIA;Vereador;Masculino;88;13;0;75
GOIANÉSIA;Vereador;Feminino;39;2;0;37
GOIANÉSIA DO PARÁ;Vereador;Masculino;51;13;0;38
GOIANÉSIA DO PARÁ;Vereador;Feminino;23;0;0;23
GOIÂNIA;Vereador;Masculino;488;31;0;457
GOIÂNIA;Vereador;Feminino;173;4;0;169
GOIANINHA;Vereador;Masculino;31;11;0;20
GOIANINHA;Vereador;Feminino;16;0;0;16
GOIANIRA;Vereador;Masculino;100;9;0;91
GOIANIRA;Vereador;Feminino;49;2;0;47
GOIANORTE;Vereador;Masculino;21;8;0;13
GOIANORTE;Vereador;Feminino;13;1;0;12
GOIÁS;Vereador;Masculino;66;5;0;61
GOIÁS;Vereador;Feminino;37;4;0;33
GOIATINS;Vereador;Masculino;34;8;0;26
GOIATINS;Vereador;Feminino;17;1;0;16
GOIATUBA;Vereador;Masculino;65;12;0;53
GOIATUBA;Vereador;Feminino;31;1;0;30
GOIOERÊ;Vereador;Masculino;48;8;0;40
GOIOERÊ;Vereador;Feminino;24;1;0;23
GOIOXIM;Vereador;Masculino;30;9;0;21
GOIOXIM;Vereador;Feminino;15;0;0;15
GONÇALVES;Vereador;Masculino;39;8;0;31
GONÇALVES;Vereador;Feminino;20;1;0;19
GONÇALVES DIAS;Vereador;Masculino;25;10;0;15
GONÇALVES DIAS;Vereador;Feminino;9;1;0;8
GONGOGI;Vereador;Masculino;43;8;0;35
GONGOGI;Vereador;Feminino;16;1;0;15
GONZAGA;Vereador;Masculino;28;9;0;19
GONZAGA;Vereador;Feminino;14;0;0;14
GOUVEIA;Vereador;Masculino;48;9;0;39
GOUVEIA;Vereador;Feminino;25;0;0;25
GOUVELÂNDIA;Vereador;Masculino;19;9;0;10
GOUVELÂNDIA;Vereador;Feminino;9;0;0;9
GOVERNADOR ARCHER;Vereador;Masculino;11;5;0;6
GOVERNADOR ARCHER;Vereador;Feminino;7;4;0;3
GOVERNADOR CELSO RAMOS;Vereador;Masculino;48;8;0;40
GOVERNADOR CELSO RAMOS;Vereador;Feminino;23;1;0;22
GOVERNADOR DIX-SEPT ROSADO;Vereador;Masculino;38;7;0;31
GOVERNADOR DIX-SEPT ROSADO;Vereador;Feminino;21;2;0;19
GOVERNADOR EDISON LOBÃO;Vereador;Masculino;77;10;0;67
GOVERNADOR EDISON LOBÃO;Vereador;Feminino;40;1;0;39
GOVERNADOR EUGÊNIO BARROS;Vereador;Masculino;30;9;0;21
GOVERNADOR EUGÊNIO BARROS;Vereador;Feminino;14;2;0;12
GOVERNADOR JORGE TEIXEIRA;Vereador;Masculino;48;4;0;44
GOVERNADOR JORGE TEIXEIRA;Vereador;Feminino;18;5;0;13
GOVERNADOR LINDENBERG;Vereador;Masculino;49;8;0;41
GOVERNADOR LINDENBERG;Vereador;Feminino;25;1;0;24
GOVERNADOR LUIZ ROCHA;Vereador;Masculino;24;7;0;17
GOVERNADOR LUIZ ROCHA;Vereador;Feminino;11;2;0;9
GOVERNADOR MANGABEIRA;Vereador;Masculino;56;9;0;47
GOVERNADOR MANGABEIRA;Vereador;Feminino;26;2;0;24
GOVERNADOR NEWTON BELLO;Vereador;Masculino;41;5;0;36
GOVERNADOR NEWTON BELLO;Vereador;Feminino;19;4;0;15
GOVERNADOR NUNES FREIRE;Vereador;Masculino;69;8;0;61
GOVERNADOR NUNES FREIRE;Vereador;Feminino;31;3;0;28
GOVERNADOR VALADARES;Vereador;Masculino;297;19;0;278
GOVERNADOR VALADARES;Vereador;Feminino;133;2;0;131
GRAÇA;Vereador;Masculino;26;8;0;18
GRAÇA;Vereador;Feminino;12;3;0;9
GRAÇA ARANHA;Vereador;Masculino;20;9;0;11
GRAÇA ARANHA;Vereador;Feminino;10;0;0;10
GRACCHO CARDOSO;Vereador;Masculino;24;8;0;16
GRACCHO CARDOSO;Vereador;Feminino;12;1;0;11
GRAJAÚ;Vereador;Masculino;97;14;0;83
GRAJAÚ;Vereador;Feminino;18;1;0;17
GRAMADO;Vereador;Masculino;58;7;0;51
GRAMADO;Vereador;Feminino;30;2;0;28
GRAMADO DOS LOUREIROS;Vereador;Masculino;15;6;0;9
GRAMADO DOS LOUREIROS;Vereador;Feminino;7;3;0;4
GRAMADO XAVIER;Vereador;Masculino;36;8;0;28
GRAMADO XAVIER;Vereador;Feminino;18;1;0;17
GRANDES RIOS;Vereador;Masculino;26;8;0;18
GRANDES RIOS;Vereador;Feminino;14;1;0;13
GRANITO;Vereador;Masculino;16;7;0;9
GRANITO;Vereador;Feminino;8;2;0;6
GRANJA;Vereador;Masculino;41;12;0;29
GRANJA;Vereador;Feminino;18;1;0;17
GRANJEIRO;Vereador;Masculino;24;9;0;15
GRANJEIRO;Vereador;Feminino;9;0;0;9
GRÃO MOGOL;Vereador;Masculino;42;9;0;33
GRÃO MOGOL;Vereador;Feminino;19;2;0;17
GRÃO-PARÁ;Vereador;Masculino;23;6;0;17
GRÃO-PARÁ;Vereador;Feminino;11;3;0;8
GRAVATÁ;Vereador;Masculino;130;13;0;117
GRAVATÁ;Vereador;Feminino;41;2;0;39
GRAVATAÍ;Vereador;Masculino;197;20;0;177
GRAVATAÍ;Vereador;Feminino;94;1;0;93
GRAVATAL;Vereador;Masculino;27;7;0;20
GRAVATAL;Vereador;Feminino;10;2;0;8
GROAÍRAS;Vereador;Masculino;26;7;0;19
GROAÍRAS;Vereador;Feminino;14;2;0;12
GROSSOS;Vereador;Masculino;20;6;0;14
GROSSOS;Vereador;Feminino;10;3;0;7
GRUPIARA;Vereador;Masculino;12;7;0;5
GRUPIARA;Vereador;Feminino;6;2;0;4
GUABIJU;Vereador;Masculino;13;8;0;5
GUABIJU;Vereador;Feminino;7;1;0;6
GUABIRUBA;Vereador;Masculino;31;9;0;22
GUABIRUBA;Vereador;Feminino;15;0;0;15
GUAÇUÍ;Vereador;Masculino;82;10;0;72
GUAÇUÍ;Vereador;Feminino;34;1;0;33
GUADALUPE;Vereador;Masculino;21;7;0;14
GUADALUPE;Vereador;Feminino;10;2;0;8
GUAÍBA;Vereador;Masculino;123;12;0;111
GUAÍBA;Vereador;Feminino;58;4;0;54
GUAIÇARA;Vereador;Masculino;48;7;0;41
GUAIÇARA;Vereador;Feminino;24;2;0;22
GUAIMBÉ;Vereador;Masculino;47;9;0;38
GUAIMBÉ;Vereador;Feminino;22;0;0;22
GUAÍRA;Vereador;Masculino;152;17;0;135
GUAÍRA;Vereador;Feminino;71;7;0;64
GUAIRAÇÁ;Vereador;Masculino;41;8;0;33
GUAIRAÇÁ;Vereador;Feminino;22;1;0;21
GUAIÚBA;Vereador;Masculino;51;8;0;43
GUAIÚBA;Vereador;Feminino;24;3;0;21
GUAJARÁ;Vereador;Masculino;32;8;0;24
GUAJARÁ;Vereador;Feminino;15;1;0;14
GUAJARÁ-MIRIM;Vereador;Masculino;96;11;0;85
GUAJARÁ-MIRIM;Vereador;Feminino;36;0;0;36
GUAJERU;Vereador;Masculino;19;6;0;13
GUAJERU;Vereador;Feminino;10;3;0;7
GUAMARÉ;Vereador;Masculino;36;7;0;29
GUAMARÉ;Vereador;Feminino;18;2;0;16
GUAMIRANGA;Vereador;Masculino;23;9;0;14
GUAMIRANGA;Vereador;Feminino;10;0;0;10
GUANAMBI;Vereador;Masculino;58;14;0;44
GUANAMBI;Vereador;Feminino;28;1;0;27
GUANHÃES;Vereador;Masculino;86;9;0;77
GUANHÃES;Vereador;Feminino;38;4;0;34
GUAPÉ;Vereador;Masculino;48;9;0;39
GUAPÉ;Vereador;Feminino;25;0;0;25
GUAPIAÇU;Vereador;Masculino;45;8;0;37
GUAPIAÇU;Vereador;Feminino;23;1;0;22
GUAPIARA;Vereador;Masculino;56;10;0;46
GUAPIARA;Vereador;Feminino;26;1;0;25
GUAPIMIRIM;Vereador;Masculino;108;7;0;101
GUAPIMIRIM;Vereador;Feminino;43;2;0;41
GUAPIRAMA;Vereador;Masculino;34;9;0;25
GUAPIRAMA;Vereador;Feminino;15;0;0;15
GUAPÓ;Vereador;Masculino;39;9;0;30
GUAPÓ;Vereador;Feminino;10;0;0;10
GUAPORÉ;Vereador;Masculino;37;10;0;27
GUAPORÉ;Vereador;Feminino;17;1;0;16
GUAPOREMA;Vereador;Masculino;12;7;0;5
GUAPOREMA;Vereador;Feminino;6;2;0;4
GUARÁ;Vereador;Masculino;31;8;0;23
GUARÁ;Vereador;Feminino;15;3;0;12
GUARABIRA;Vereador;Masculino;71;13;0;58
GUARABIRA;Vereador;Feminino;36;2;0;34
GUARAÇAÍ;Vereador;Masculino;29;9;0;20
GUARAÇAÍ;Vereador;Feminino;15;0;0;15
GUARACI;Vereador;Masculino;70;16;0;54
GUARACI;Vereador;Feminino;38;2;0;36
GUARACIABA;Vereador;Masculino;57;16;0;41
GUARACIABA;Vereador;Feminino;28;2;0;26
GUARACIABA DO NORTE;Vereador;Masculino;35;11;0;24
GUARACIABA DO NORTE;Vereador;Feminino;18;2;0;16
GUARACIAMA;Vereador;Masculino;31;9;0;22
GUARACIAMA;Vereador;Feminino;15;0;0;15
GUARAÍ;Vereador;Masculino;49;8;0;41
GUARAÍ;Vereador;Feminino;23;1;0;22
GUARAÍTA;Vereador;Masculino;22;6;0;16
GUARAÍTA;Vereador;Feminino;8;3;0;5
GUARAMIRANGA;Vereador;Masculino;33;9;0;24
GUARAMIRANGA;Vereador;Feminino;18;0;0;18
GUARAMIRIM;Vereador;Masculino;55;8;0;47
GUARAMIRIM;Vereador;Feminino;26;1;0;25
GUARANÉSIA;Vereador;Masculino;79;11;0;68
GUARANÉSIA;Vereador;Feminino;38;0;0;38
GUARANI;Vereador;Masculino;31;7;0;24
GUARANI;Vereador;Feminino;15;2;0;13
GUARANI DAS MISSÕES;Vereador;Masculino;24;9;0;15
GUARANI DAS MISSÕES;Vereador;Feminino;15;0;0;15
GUARANI DE GOIÁS;Vereador;Masculino;30;8;0;22
GUARANI DE GOIÁS;Vereador;Feminino;14;1;0;13
GUARANI D'OESTE;Vereador;Masculino;19;9;0;10
GUARANI D'OESTE;Vereador;Feminino;10;0;0;10
GUARANIAÇU;Vereador;Masculino;49;9;0;40
GUARANIAÇU;Vereador;Feminino;8;0;0;8
GUARANTÃ;Vereador;Masculino;52;7;0;45
GUARANTÃ;Vereador;Feminino;28;2;0;26
GUARANTÃ DO NORTE;Vereador;Masculino;46;7;0;39
GUARANTÃ DO NORTE;Vereador;Feminino;24;2;0;22
GUARAPARI;Vereador;Masculino;128;15;0;113
GUARAPARI;Vereador;Feminino;50;2;0;48
GUARAPUAVA;Vereador;Masculino;163;19;0;144
GUARAPUAVA;Vereador;Feminino;47;2;0;45
GUARAQUEÇABA;Vereador;Masculino;41;8;0;33
GUARAQUEÇABA;Vereador;Feminino;21;1;0;20
GUARARÁ;Vereador;Masculino;37;7;0;30
GUARARÁ;Vereador;Feminino;19;2;0;17
GUARARAPES;Vereador;Masculino;48;8;0;40
GUARARAPES;Vereador;Feminino;24;1;0;23
GUARAREMA;Vereador;Masculino;82;8;0;74
GUARAREMA;Vereador;Feminino;39;3;0;36
GUARATINGA;Vereador;Masculino;46;9;0;37
GUARATINGA;Vereador;Feminino;24;2;0;22
GUARATINGUETÁ;Vereador;Masculino;142;11;0;131
GUARATINGUETÁ;Vereador;Feminino;75;0;0;75
GUARATUBA;Vereador;Masculino;95;11;0;84
GUARATUBA;Vereador;Feminino;45;2;0;43
GUARDA-MOR;Vereador;Masculino;22;9;0;13
GUARDA-MOR;Vereador;Feminino;11;0;0;11
GUAREÍ;Vereador;Masculino;43;7;0;36
GUAREÍ;Vereador;Feminino;22;2;0;20
GUARIBA;Vereador;Masculino;92;8;0;84
GUARIBA;Vereador;Feminino;40;1;0;39
GUARIBAS;Vereador;Masculino;13;7;0;6
GUARIBAS;Vereador;Feminino;7;2;0;5
GUARINOS;Vereador;Masculino;15;8;0;7
GUARINOS;Vereador;Feminino;8;1;0;7
GUARUJÁ;Vereador;Masculino;273;17;0;256
GUARUJÁ;Vereador;Feminino;118;0;0;118
GUARUJÁ DO SUL;Vereador;Masculino;19;7;0;12
GUARUJÁ DO SUL;Vereador;Feminino;9;2;0;7
GUARULHOS;Vereador;Masculino;754;32;0;722
GUARULHOS;Vereador;Feminino;330;2;0;328
GUATAMBÚ;Vereador;Masculino;22;7;0;15
GUATAMBÚ;Vereador;Feminino;10;2;0;8
GUATAPARÁ;Vereador;Masculino;52;9;0;43
GUATAPARÁ;Vereador;Feminino;26;0;0;26
GUAXUPÉ;Vereador;Masculino;105;10;0;95
GUAXUPÉ;Vereador;Feminino;48;3;0;45
GUIA LOPES DA LAGUNA;Vereador;Masculino;24;8;0;16
GUIA LOPES DA LAGUNA;Vereador;Feminino;12;1;0;11
GUIDOVAL;Vereador;Masculino;37;7;0;30
GUIDOVAL;Vereador;Feminino;20;2;0;18
GUIMARÃES;Vereador;Masculino;44;7;0;37
GUIMARÃES;Vereador;Feminino;21;2;0;19
GUIMARÂNIA;Vereador;Masculino;37;8;0;29
GUIMARÂNIA;Vereador;Feminino;18;1;0;17
GUIRATINGA;Vereador;Masculino;19;7;0;12
GUIRATINGA;Vereador;Feminino;10;2;0;8
GUIRICEMA;Vereador;Masculino;30;7;0;23
GUIRICEMA;Vereador;Feminino;16;2;0;14
GURINHATÃ;Vereador;Masculino;30;8;0;22
GURINHATÃ;Vereador;Feminino;16;1;0;15
GURINHÉM;Vereador;Masculino;33;8;0;25
GURINHÉM;Vereador;Feminino;16;1;0;15
GURJÃO;Vereador;Masculino;19;6;0;13
GURJÃO;Vereador;Feminino;7;3;0;4
GURUPÁ;Vereador;Masculino;35;8;0;27
GURUPÁ;Vereador;Feminino;17;3;0;14
GURUPI;Vereador;Masculino;75;11;0;64
GURUPI;Vereador;Feminino;36;2;0;34
GUZOLÂNDIA;Vereador;Masculino;35;9;0;26
GUZOLÂNDIA;Vereador;Feminino;17;0;0;17
HARMONIA;Vereador;Masculino;20;9;0;11
HARMONIA;Vereador;Feminino;13;0;0;13
HEITORAÍ;Vereador;Masculino;23;7;0;16
HEITORAÍ;Vereador;Feminino;11;2;0;9
HELIODORA;Vereador;Masculino;32;7;0;25
HELIODORA;Vereador;Feminino;19;2;0;17
HELIÓPOLIS;Vereador;Masculino;23;8;0;15
HELIÓPOLIS;Vereador;Feminino;10;1;0;9
HERCULÂNDIA;Vereador;Masculino;31;9;0;22
HERCULÂNDIA;Vereador;Feminino;15;0;0;15
HERVAL;Vereador;Masculino;24;9;0;15
HERVAL;Vereador;Feminino;12;0;0;12
HERVAL D'OESTE;Vereador;Masculino;50;11;0;39
HERVAL D'OESTE;Vereador;Feminino;24;0;0;24
HERVEIRAS;Vereador;Masculino;22;8;0;14
HERVEIRAS;Vereador;Feminino;11;1;0;10
HIDROLÂNDIA;Vereador;Masculino;102;21;0;81
HIDROLÂNDIA;Vereador;Feminino;54;1;0;53
HIDROLINA;Vereador;Masculino;23;7;0;16
HIDROLINA;Vereador;Feminino;12;2;0;10
HOLAMBRA;Vereador;Masculino;48;8;0;40
HOLAMBRA;Vereador;Feminino;24;1;0;23
HONÓRIO SERPA;Vereador;Masculino;24;9;0;15
HONÓRIO SERPA;Vereador;Feminino;12;0;0;12
HORIZONTE;Vereador;Masculino;103;12;0;91
HORIZONTE;Vereador;Feminino;43;3;0;40
HORIZONTINA;Vereador;Masculino;35;8;0;27
HORIZONTINA;Vereador;Feminino;17;1;0;16
HORTOLÂNDIA;Vereador;Masculino;227;18;0;209
HORTOLÂNDIA;Vereador;Feminino;109;1;0;108
HUGO NAPOLEÃO;Vereador;Masculino;21;7;0;14
HUGO NAPOLEÃO;Vereador;Feminino;10;2;0;8
HULHA NEGRA;Vereador;Masculino;40;8;0;32
HULHA NEGRA;Vereador;Feminino;20;1;0;19
HUMAITÁ;Vereador;Masculino;91;19;0;72
HUMAITÁ;Vereador;Feminino;37;3;0;34
HUMBERTO DE CAMPOS;Vereador;Masculino;51;8;0;43
HUMBERTO DE CAMPOS;Vereador;Feminino;24;3;0;21
IACANGA;Vereador;Masculino;34;6;0;28
IACANGA;Vereador;Feminino;17;3;0;14
IACIARA;Vereador;Masculino;35;8;0;27
IACIARA;Vereador;Feminino;19;1;0;18
IACRI;Vereador;Masculino;44;8;0;36
IACRI;Vereador;Feminino;23;1;0;22
IAÇU;Vereador;Masculino;47;9;0;38
IAÇU;Vereador;Feminino;21;2;0;19
IAPU;Vereador;Masculino;32;8;0;24
IAPU;Vereador;Feminino;17;1;0;16
IARAS;Vereador;Masculino;33;8;0;25
IARAS;Vereador;Feminino;15;1;0;14
IATI;Vereador;Masculino;39;7;0;32
IATI;Vereador;Feminino;16;2;0;14
IBAITI;Vereador;Masculino;75;6;0;69
IBAITI;Vereador;Feminino;37;3;0;34
IBARAMA;Vereador;Masculino;18;8;0;10
IBARAMA;Vereador;Feminino;9;1;0;8
IBARETAMA;Vereador;Masculino;32;6;0;26
IBARETAMA;Vereador;Feminino;16;3;0;13
IBATÉ;Vereador;Masculino;81;8;0;73
IBATÉ;Vereador;Feminino;39;1;0;38
IBATEGUARA;Vereador;Masculino;42;10;0;32
IBATEGUARA;Vereador;Feminino;19;1;0;18
IBATIBA;Vereador;Masculino;44;9;0;35
IBATIBA;Vereador;Feminino;22;0;0;22
IBEMA;Vereador;Masculino;41;9;0;32
IBEMA;Vereador;Feminino;18;0;0;18
IBERTIOGA;Vereador;Masculino;32;9;0;23
IBERTIOGA;Vereador;Feminino;16;0;0;16
IBIÁ;Vereador;Masculino;93;8;0;85
IBIÁ;Vereador;Feminino;43;3;0;40
IBIAÇÁ;Vereador;Masculino;17;6;0;11
IBIAÇÁ;Vereador;Feminino;8;3;0;5
IBIAÍ;Vereador;Masculino;47;8;0;39
IBIAÍ;Vereador;Feminino;24;1;0;23
IBIAM;Vereador;Masculino;23;8;0;15
IBIAM;Vereador;Feminino;10;1;0;9
IBIAPINA;Vereador;Masculino;37;9;0;28
IBIAPINA;Vereador;Feminino;18;2;0;16
IBIARA;Vereador;Masculino;17;8;0;9
IBIARA;Vereador;Feminino;10;1;0;9
IBIASSUCÊ;Vereador;Masculino;20;6;0;14
IBIASSUCÊ;Vereador;Feminino;10;3;0;7
IBICARAÍ;Vereador;Masculino;65;9;0;56
IBICARAÍ;Vereador;Feminino;25;2;0;23
IBICARÉ;Vereador;Masculino;19;9;0;10
IBICARÉ;Vereador;Feminino;9;0;0;9
IBICOARA;Vereador;Masculino;33;10;0;23
IBICOARA;Vereador;Feminino;14;1;0;13
IBICUÍ;Vereador;Masculino;37;6;0;31
IBICUÍ;Vereador;Feminino;16;3;0;13
IBICUITINGA;Vereador;Masculino;53;8;0;45
IBICUITINGA;Vereador;Feminino;26;1;0;25
IBIMIRIM;Vereador;Masculino;58;8;0;50
IBIMIRIM;Vereador;Feminino;30;3;0;27
IBIPEBA;Vereador;Masculino;20;11;0;9
IBIPEBA;Vereador;Feminino;11;0;0;11
IBIPITANGA;Vereador;Masculino;26;9;0;17
IBIPITANGA;Vereador;Feminino;14;0;0;14
IBIPORÃ;Vereador;Masculino;76;8;0;68
IBIPORÃ;Vereador;Feminino;37;1;0;36
IBIQUERA;Vereador;Masculino;24;8;0;16
IBIQUERA;Vereador;Feminino;12;1;0;11
IBIRÁ;Vereador;Masculino;46;8;0;38
IBIRÁ;Vereador;Feminino;22;1;0;21
IBIRACATU;Vereador;Masculino;35;8;0;27
IBIRACATU;Vereador;Feminino;18;1;0;17
IBIRACI;Vereador;Masculino;36;6;0;30
IBIRACI;Vereador;Feminino;18;3;0;15
IBIRAÇU;Vereador;Masculino;52;9;0;43
IBIRAÇU;Vereador;Feminino;26;0;0;26
IBIRAIARAS;Vereador;Masculino;24;9;0;15
IBIRAIARAS;Vereador;Feminino;13;0;0;13
IBIRAJUBA;Vereador;Masculino;17;8;0;9
IBIRAJUBA;Vereador;Feminino;9;1;0;8
IBIRAMA;Vereador;Masculino;47;10;0;37
IBIRAMA;Vereador;Feminino;23;1;0;22
IBIRAPITANGA;Vereador;Masculino;58;8;0;50
IBIRAPITANGA;Vereador;Feminino;26;3;0;23
IBIRAPUÃ;Vereador;Masculino;32;8;0;24
IBIRAPUÃ;Vereador;Feminino;17;1;0;16
IBIRAPUITÃ;Vereador;Masculino;28;9;0;19
IBIRAPUITÃ;Vereador;Feminino;14;0;0;14
IBIRAREMA;Vereador;Masculino;39;7;0;32
IBIRAREMA;Vereador;Feminino;20;2;0;18
IBIRATAIA;Vereador;Masculino;68;11;0;57
IBIRATAIA;Vereador;Feminino;25;0;0;25
IBIRITÉ;Vereador;Masculino;192;15;0;177
IBIRITÉ;Vereador;Feminino;84;0;0;84
IBIRUBÁ;Vereador;Masculino;29;10;0;19
IBIRUBÁ;Vereador;Feminino;14;1;0;13
IBITIARA;Vereador;Masculino;30;11;0;19
IBITIARA;Vereador;Feminino;14;0;0;14
IBITINGA;Vereador;Masculino;155;10;0;145
IBITINGA;Vereador;Feminino;72;0;0;72
IBITIRAMA;Vereador;Masculino;38;9;0;29
IBITIRAMA;Vereador;Feminino;17;0;0;17
IBITITÁ;Vereador;Masculino;28;11;0;17
IBITITÁ;Vereador;Feminino;12;0;0;12
IBITIÚRA DE MINAS;Vereador;Masculino;23;9;0;14
IBITIÚRA DE MINAS;Vereador;Feminino;12;0;0;12
IBITURUNA;Vereador;Masculino;18;8;0;10
IBITURUNA;Vereador;Feminino;12;1;0;11
IBIÚNA;Vereador;Masculino;211;13;0;198
IBIÚNA;Vereador;Feminino;89;2;0;87
IBOTIRAMA;Vereador;Masculino;32;10;0;22
IBOTIRAMA;Vereador;Feminino;17;1;0;16
ICAPUÍ;Vereador;Masculino;25;10;0;15
ICAPUÍ;Vereador;Feminino;13;1;0;12
IÇARA;Vereador;Masculino;57;10;0;47
IÇARA;Vereador;Feminino;28;1;0;27
ICARAÍ DE MINAS;Vereador;Masculino;20;9;0;11
ICARAÍ DE MINAS;Vereador;Feminino;9;0;0;9
ICARAÍMA;Vereador;Masculino;26;9;0;17
ICARAÍMA;Vereador;Feminino;11;0;0;11
ICATU;Vereador;Masculino;58;10;0;48
ICATU;Vereador;Feminino;29;1;0;28
ICÉM;Vereador;Masculino;62;9;0;53
ICÉM;Vereador;Feminino;32;0;0;32
ICHU;Vereador;Masculino;23;7;0;16
ICHU;Vereador;Feminino;11;2;0;9
ICÓ;Vereador;Masculino;49;14;0;35
ICÓ;Vereador;Feminino;24;1;0;23
ICONHA;Vereador;Masculino;45;8;0;37
ICONHA;Vereador;Feminino;24;1;0;23
IELMO MARINHO;Vereador;Masculino;32;8;0;24
IELMO MARINHO;Vereador;Feminino;17;1;0;16
IEPÊ;Vereador;Masculino;53;8;0;45
IEPÊ;Vereador;Feminino;26;1;0;25
IGACI;Vereador;Masculino;30;9;0;21
IGACI;Vereador;Feminino;16;2;0;14
IGAPORÃ;Vereador;Masculino;26;9;0;17
IGAPORÃ;Vereador;Feminino;13;2;0;11
IGARAÇU DO TIETÊ;Vereador;Masculino;63;11;0;52
IGARAÇU DO TIETÊ;Vereador;Feminino;30;0;0;30
IGARACY;Vereador;Masculino;15;9;0;6
IGARACY;Vereador;Feminino;10;0;0;10
IGARAPAVA;Vereador;Masculino;101;10;0;91
IGARAPAVA;Vereador;Feminino;49;1;0;48
IGARAPÉ;Vereador;Masculino;123;11;0;112
IGARAPÉ;Vereador;Feminino;56;2;0;54
IGARAPÉ DO MEIO;Vereador;Masculino;37;6;0;31
IGARAPÉ DO MEIO;Vereador;Feminino;14;3;0;11
IGARAPÉ GRANDE;Vereador;Masculino;23;9;0;14
IGARAPÉ GRANDE;Vereador;Feminino;11;0;0;11
IGARAPÉ-AÇU;Vereador;Masculino;62;13;0;49
IGARAPÉ-AÇU;Vereador;Feminino;27;0;0;27
IGARAPÉ-MIRI;Vereador;Masculino;82;9;0;73
IGARAPÉ-MIRI;Vereador;Feminino;38;4;0;34
IGARASSU;Vereador;Masculino;134;11;0;123
IGARASSU;Vereador;Feminino;52;2;0;50
IGARATÁ;Vereador;Masculino;35;9;0;26
IGARATÁ;Vereador;Feminino;17;0;0;17
IGARATINGA;Vereador;Masculino;28;8;0;20
IGARATINGA;Vereador;Feminino;16;1;0;15
IGRAPIÚNA;Vereador;Masculino;51;7;0;44
IGRAPIÚNA;Vereador;Feminino;23;2;0;21
IGREJA NOVA;Vereador;Masculino;37;10;0;27
IGREJA NOVA;Vereador;Feminino;16;1;0;15
IGREJINHA;Vereador;Masculino;65;9;0;56
IGREJINHA;Vereador;Feminino;34;0;0;34
IGUABA GRANDE;Vereador;Masculino;93;11;0;82
IGUABA GRANDE;Vereador;Feminino;43;0;0;43
IGUAÍ;Vereador;Masculino;47;11;0;36
IGUAÍ;Vereador;Feminino;23;0;0;23
IGUAPE;Vereador;Masculino;67;9;0;58
IGUAPE;Vereador;Feminino;33;0;0;33
IGUARACI;Vereador;Masculino;25;8;0;17
IGUARACI;Vereador;Feminino;10;1;0;9
IGUARAÇU;Vereador;Masculino;23;7;0;16
IGUARAÇU;Vereador;Feminino;11;2;0;9
IGUATAMA;Vereador;Masculino;41;8;0;33
IGUATAMA;Vereador;Feminino;21;1;0;20
IGUATEMI;Vereador;Masculino;55;7;0;48
IGUATEMI;Vereador;Feminino;28;2;0;26
IGUATU;Vereador;Masculino;94;23;0;71
IGUATU;Vereador;Feminino;40;3;0;37
IJACI;Vereador;Masculino;65;9;0;56
IJACI;Vereador;Feminino;31;0;0;31
IJUÍ;Vereador;Masculino;65;12;0;53
IJUÍ;Vereador;Feminino;30;3;0;27
ILHA COMPRIDA;Vereador;Masculino;57;8;0;49
ILHA COMPRIDA;Vereador;Feminino;30;1;0;29
ILHA DAS FLORES;Vereador;Masculino;22;8;0;14
ILHA DAS FLORES;Vereador;Feminino;12;1;0;11
ILHA DE ITAMARACÁ;Vereador;Masculino;64;9;0;55
ILHA DE ITAMARACÁ;Vereador;Feminino;31;0;0;31
ILHA GRANDE;Vereador;Masculino;37;5;0;32
ILHA GRANDE;Vereador;Feminino;24;4;0;20
ILHA SOLTEIRA;Vereador;Masculino;68;8;0;60
ILHA SOLTEIRA;Vereador;Feminino;35;1;0;34
ILHABELA;Vereador;Masculino;84;6;0;78
ILHABELA;Vereador;Feminino;42;3;0;39
ILHÉUS;Vereador;Masculino;203;19;0;184
ILHÉUS;Vereador;Feminino;84;0;0;84
ILHOTA;Vereador;Masculino;27;8;0;19
ILHOTA;Vereador;Feminino;13;1;0;12
ILICÍNEA;Vereador;Masculino;57;4;0;53
ILICÍNEA;Vereador;Feminino;27;5;0;22
ILÓPOLIS;Vereador;Masculino;22;6;0;16
ILÓPOLIS;Vereador;Feminino;12;3;0;9
IMACULADA;Vereador;Masculino;21;8;0;13
IMACULADA;Vereador;Feminino;9;1;0;8
IMARUÍ;Vereador;Masculino;50;9;0;41
IMARUÍ;Vereador;Feminino;24;0;0;24
IMBAÚ;Vereador;Masculino;40;9;0;31
IMBAÚ;Vereador;Feminino;17;0;0;17
IMBÉ;Vereador;Masculino;53;8;0;45
IMBÉ;Vereador;Feminino;27;1;0;26
IMBÉ DE MINAS;Vereador;Masculino;23;7;0;16
IMBÉ DE MINAS;Vereador;Feminino;11;2;0;9
IMBITUBA;Vereador;Masculino;91;11;0;80
IMBITUBA;Vereador;Feminino;45;2;0;43
IMBITUVA;Vereador;Masculino;50;10;0;40
IMBITUVA;Vereador;Feminino;14;1;0;13
IMBUIA;Vereador;Masculino;20;9;0;11
IMBUIA;Vereador;Feminino;9;0;0;9
IMIGRANTE;Vereador;Masculino;23;7;0;16
IMIGRANTE;Vereador;Feminino;12;2;0;10
IMPERATRIZ;Vereador;Masculino;231;18;0;213
IMPERATRIZ;Vereador;Feminino;100;3;0;97
INÁCIO MARTINS;Vereador;Masculino;41;9;0;32
INÁCIO MARTINS;Vereador;Feminino;20;0;0;20
INACIOLÂNDIA;Vereador;Masculino;35;9;0;26
INACIOLÂNDIA;Vereador;Feminino;17;0;0;17
INAJÁ;Vereador;Masculino;72;19;0;53
INAJÁ;Vereador;Feminino;32;1;0;31
INCONFIDENTES;Vereador;Masculino;49;9;0;40
INCONFIDENTES;Vereador;Feminino;23;0;0;23
INDAIABIRA;Vereador;Masculino;30;9;0;21
INDAIABIRA;Vereador;Feminino;14;0;0;14
INDAIAL;Vereador;Masculino;73;12;0;61
INDAIAL;Vereador;Feminino;36;1;0;35
INDAIATUBA;Vereador;Masculino;131;12;0;119
INDAIATUBA;Vereador;Feminino;63;0;0;63
INDEPENDÊNCIA;Vereador;Masculino;39;18;0;21
INDEPENDÊNCIA;Vereador;Feminino;20;2;0;18
INDIANA;Vereador;Masculino;37;7;0;30
INDIANA;Vereador;Feminino;21;2;0;19
INDIANÓPOLIS;Vereador;Masculino;72;16;0;56
INDIANÓPOLIS;Vereador;Feminino;30;2;0;28
INDIAPORÃ;Vereador;Masculino;20;7;0;13
INDIAPORÃ;Vereador;Feminino;10;2;0;8
INDIARA;Vereador;Masculino;44;7;0;37
INDIARA;Vereador;Feminino;24;2;0;22
INDIAROBA;Vereador;Masculino;42;10;0;32
INDIAROBA;Vereador;Feminino;20;1;0;19
INDIAVAÍ;Vereador;Masculino;29;9;0;20
INDIAVAÍ;Vereador;Feminino;14;0;0;14
INGÁ;Vereador;Masculino;59;11;0;48
INGÁ;Vereador;Feminino;35;0;0;35
INGAÍ;Vereador;Masculino;32;9;0;23
INGAÍ;Vereador;Feminino;15;0;0;15
INGAZEIRA;Vereador;Masculino;16;8;0;8
INGAZEIRA;Vereador;Feminino;8;1;0;7
INHACORÁ;Vereador;Masculino;17;6;0;11
INHACORÁ;Vereador;Feminino;9;3;0;6
INHAMBUPE;Vereador;Masculino;66;11;0;55
INHAMBUPE;Vereador;Feminino;31;2;0;29
INHANGAPI;Vereador;Masculino;39;8;0;31
INHANGAPI;Vereador;Feminino;17;1;0;16
INHAPI;Vereador;Masculino;28;10;0;18
INHAPI;Vereador;Feminino;14;1;0;13
INHAPIM;Vereador;Masculino;52;9;0;43
INHAPIM;Vereador;Feminino;23;2;0;21
INHAÚMA;Vereador;Masculino;43;7;0;36
INHAÚMA;Vereador;Feminino;23;2;0;21
INHUMA;Vereador;Masculino;23;8;0;15
INHUMA;Vereador;Feminino;12;1;0;11
INHUMAS;Vereador;Masculino;97;13;0;84
INHUMAS;Vereador;Feminino;44;0;0;44
INIMUTABA;Vereador;Masculino;63;9;0;54
INIMUTABA;Vereador;Feminino;32;0;0;32
INOCÊNCIA;Vereador;Masculino;25;8;0;17
INOCÊNCIA;Vereador;Feminino;13;1;0;12
INÚBIA PAULISTA;Vereador;Masculino;30;6;0;24
INÚBIA PAULISTA;Vereador;Feminino;16;3;0;13
IOMERÊ;Vereador;Masculino;17;7;0;10
IOMERÊ;Vereador;Feminino;8;2;0;6
IPABA;Vereador;Masculino;79;9;0;70
IPABA;Vereador;Feminino;38;2;0;36
IPAMERI;Vereador;Masculino;67;9;0;58
IPAMERI;Vereador;Feminino;34;2;0;32
IPANEMA;Vereador;Masculino;76;11;0;65
IPANEMA;Vereador;Feminino;38;0;0;38
IPANGUAÇU;Vereador;Masculino;58;7;0;51
IPANGUAÇU;Vereador;Feminino;30;2;0;28
IPAPORANGA;Vereador;Masculino;19;9;0;10
IPAPORANGA;Vereador;Feminino;10;0;0;10
IPATINGA;Vereador;Masculino;201;18;0;183
IPATINGA;Vereador;Feminino;88;1;0;87
IPAUMIRIM;Vereador;Masculino;20;4;0;16
IPAUMIRIM;Vereador;Feminino;10;5;0;5
IPAUSSU;Vereador;Masculino;57;9;0;48
IPAUSSU;Vereador;Feminino;25;0;0;25
IPÊ;Vereador;Masculino;21;7;0;14
IPÊ;Vereador;Feminino;10;2;0;8
IPECAETÁ;Vereador;Masculino;44;10;0;34
IPECAETÁ;Vereador;Feminino;20;1;0;19
IPERÓ;Vereador;Masculino;96;10;0;86
IPERÓ;Vereador;Feminino;42;1;0;41
IPEÚNA;Vereador;Masculino;67;8;0;59
IPEÚNA;Vereador;Feminino;38;1;0;37
IPIAÇU;Vereador;Masculino;31;8;0;23
IPIAÇU;Vereador;Feminino;15;1;0;14
IPIAÚ;Vereador;Masculino;75;11;0;64
IPIAÚ;Vereador;Feminino;27;2;0;25
IPIGUÁ;Vereador;Masculino;39;7;0;32
IPIGUÁ;Vereador;Feminino;18;2;0;16
IPIRA;Vereador;Masculino;13;7;0;6
IPIRA;Vereador;Feminino;7;2;0;5
IPIRÁ;Vereador;Masculino;43;14;0;29
IPIRÁ;Vereador;Feminino;20;1;0;19
IPIRANGA;Vereador;Masculino;55;9;0;46
IPIRANGA;Vereador;Feminino;26;0;0;26
IPIRANGA DE GOIÁS;Vereador;Masculino;21;8;0;13
IPIRANGA DE GOIÁS;Vereador;Feminino;11;1;0;10
IPIRANGA DO NORTE;Vereador;Masculino;25;7;0;18
IPIRANGA DO NORTE;Vereador;Feminino;15;2;0;13
IPIRANGA DO PIAUÍ;Vereador;Masculino;21;7;0;14
IPIRANGA DO PIAUÍ;Vereador;Feminino;12;2;0;10
IPIRANGA DO SUL;Vereador;Masculino;18;8;0;10
IPIRANGA DO SUL;Vereador;Feminino;8;1;0;7
IPIXUNA;Vereador;Masculino;30;11;0;19
IPIXUNA;Vereador;Feminino;14;0;0;14
IPIXUNA DO PARÁ;Vereador;Masculino;86;8;0;78
IPIXUNA DO PARÁ;Vereador;Feminino;39;3;0;36
IPOJUCA;Vereador;Masculino;89;9;0;80
IPOJUCA;Vereador;Feminino;32;1;0;31
IPORÁ;Vereador;Masculino;51;13;0;38
IPORÁ;Vereador;Feminino;23;0;0;23
IPORÃ;Vereador;Masculino;33;9;0;24
IPORÃ;Vereador;Feminino;18;0;0;18
IPORÃ DO OESTE;Vereador;Masculino;17;8;0;9
IPORÃ DO OESTE;Vereador;Feminino;8;1;0;7
IPORANGA;Vereador;Masculino;40;8;0;32
IPORANGA;Vereador;Feminino;19;1;0;18
IPU;Vereador;Masculino;45;11;0;34
IPU;Vereador;Feminino;22;2;0;20
IPUÃ;Vereador;Masculino;44;9;0;35
IPUÃ;Vereador;Feminino;20;0;0;20
IPUAÇU;Vereador;Masculino;18;8;0;10
IPUAÇU;Vereador;Feminino;10;1;0;9
IPUBI;Vereador;Masculino;37;8;0;29
IPUBI;Vereador;Feminino;11;3;0;8
IPUEIRA;Vereador;Masculino;11;6;0;5
IPUEIRA;Vereador;Feminino;7;3;0;4
IPUEIRAS;Vereador;Masculino;67;19;0;48
IPUEIRAS;Vereador;Feminino;31;3;0;28
IPUIÚNA;Vereador;Masculino;25;7;0;18
IPUIÚNA;Vereador;Feminino;11;2;0;9
IPUMIRIM;Vereador;Masculino;23;7;0;16
IPUMIRIM;Vereador;Feminino;11;2;0;9
IPUPIARA;Vereador;Masculino;16;8;0;8
IPUPIARA;Vereador;Feminino;8;1;0;7
IRACEMA;Vereador;Masculino;69;17;0;52
IRACEMA;Vereador;Feminino;33;1;0;32
IRACEMA DO OESTE;Vereador;Masculino;15;8;0;7
IRACEMA DO OESTE;Vereador;Feminino;9;1;0;8
IRACEMÁPOLIS;Vereador;Masculino;66;10;0;56
IRACEMÁPOLIS;Vereador;Feminino;32;1;0;31
IRACEMINHA;Vereador;Masculino;14;9;0;5
IRACEMINHA;Vereador;Feminino;6;0;0;6
IRAÍ;Vereador;Masculino;28;8;0;20
IRAÍ;Vereador;Feminino;13;1;0;12
IRAÍ DE MINAS;Vereador;Masculino;21;7;0;14
IRAÍ DE MINAS;Vereador;Feminino;10;2;0;8
IRAJUBA;Vereador;Masculino;23;9;0;14
IRAJUBA;Vereador;Feminino;12;0;0;12
IRAMAIA;Vereador;Masculino;32;8;0;24
IRAMAIA;Vereador;Feminino;16;1;0;15
IRANDUBA;Vereador;Masculino;86;12;0;74
IRANDUBA;Vereador;Feminino;40;1;0;39
IRANI;Vereador;Masculino;29;7;0;22
IRANI;Vereador;Feminino;16;2;0;14
IRAPUÃ;Vereador;Masculino;21;8;0;13
IRAPUÃ;Vereador;Feminino;10;1;0;9
IRAPURU;Vereador;Masculino;36;8;0;28
IRAPURU;Vereador;Feminino;18;1;0;17
IRAQUARA;Vereador;Masculino;68;10;0;58
IRAQUARA;Vereador;Feminino;33;1;0;32
IRARÁ;Vereador;Masculino;64;10;0;54
IRARÁ;Vereador;Feminino;29;1;0;28
IRATI;Vereador;Masculino;105;19;0;86
IRATI;Vereador;Feminino;50;0;0;50
IRAUÇUBA;Vereador;Masculino;38;9;0;29
IRAUÇUBA;Vereador;Feminino;13;2;0;11
IRECÊ;Vereador;Masculino;99;12;0;87
IRECÊ;Vereador;Feminino;41;3;0;38
IRETAMA;Vereador;Masculino;52;9;0;43
IRETAMA;Vereador;Feminino;16;0;0;16
IRINEÓPOLIS;Vereador;Masculino;48;6;0;42
IRINEÓPOLIS;Vereador;Feminino;21;3;0;18
IRITUIA;Vereador;Masculino;61;11;0;50
IRITUIA;Vereador;Feminino;29;2;0;27
IRUPI;Vereador;Masculino;48;6;0;42
IRUPI;Vereador;Feminino;24;3;0;21
ISAÍAS COELHO;Vereador;Masculino;18;6;0;12
ISAÍAS COELHO;Vereador;Feminino;8;3;0;5
ISRAELÂNDIA;Vereador;Masculino;17;8;0;9
ISRAELÂNDIA;Vereador;Feminino;10;1;0;9
ITÁ;Vereador;Masculino;23;7;0;16
ITÁ;Vereador;Feminino;12;2;0;10
ITAARA;Vereador;Masculino;25;7;0;18
ITAARA;Vereador;Feminino;17;2;0;15
ITABAIANA;Vereador;Masculino;94;19;0;75
ITABAIANA;Vereador;Feminino;44;4;0;40
ITABAIANINHA;Vereador;Masculino;50;9;0;41
ITABAIANINHA;Vereador;Feminino;24;4;0;20
ITABELA;Vereador;Masculino;85;10;0;75
ITABELA;Vereador;Feminino;33;1;0;32
ITABERÁ;Vereador;Masculino;55;9;0;46
ITABERÁ;Vereador;Feminino;30;0;0;30
ITABERABA;Vereador;Masculino;68;15;0;53
ITABERABA;Vereador;Feminino;33;0;0;33
ITABERAÍ;Vereador;Masculino;50;13;0;37
ITABERAÍ;Vereador;Feminino;24;0;0;24
ITABI;Vereador;Masculino;23;9;0;14
ITABI;Vereador;Feminino;10;0;0;10
ITABIRA;Vereador;Masculino;169;16;0;153
ITABIRA;Vereador;Feminino;85;1;0;84
ITABIRINHA;Vereador;Masculino;32;8;0;24
ITABIRINHA;Vereador;Feminino;17;1;0;16
ITABIRITO;Vereador;Masculino;151;12;0;139
ITABIRITO;Vereador;Feminino;69;1;0;68
ITABORAÍ;Vereador;Masculino;236;14;0;222
ITABORAÍ;Vereador;Feminino;94;1;0;93
ITABUNA;Vereador;Masculino;268;19;0;249
ITABUNA;Vereador;Feminino;114;2;0;112
ITACAJÁ;Vereador;Masculino;22;9;0;13
ITACAJÁ;Vereador;Feminino;11;0;0;11
ITACAMBIRA;Vereador;Masculino;32;9;0;23
ITACAMBIRA;Vereador;Feminino;15;0;0;15
ITACARAMBI;Vereador;Masculino;30;8;0;22
ITACARAMBI;Vereador;Feminino;15;3;0;12
ITACARÉ;Vereador;Masculino;85;11;0;74
ITACARÉ;Vereador;Feminino;38;0;0;38
ITACOATIARA;Vereador;Masculino;143;14;0;129
ITACOATIARA;Vereador;Feminino;55;1;0;54
ITACURUBA;Vereador;Masculino;24;7;0;17
ITACURUBA;Vereador;Feminino;12;2;0;10
ITACURUBI;Vereador;Masculino;22;8;0;14
ITACURUBI;Vereador;Feminino;11;1;0;10
ITAETÉ;Vereador;Masculino;35;8;0;27
ITAETÉ;Vereador;Feminino;16;1;0;15
ITAGI;Vereador;Masculino;33;8;0;25
ITAGI;Vereador;Feminino;15;1;0;14
ITAGIBÁ;Vereador;Masculino;69;11;0;58
ITAGIBÁ;Vereador;Feminino;34;0;0;34
ITAGIMIRIM;Vereador;Masculino;59;7;0;52
ITAGIMIRIM;Vereador;Feminino;31;2;0;29
ITAGUAÇU;Vereador;Masculino;51;8;0;43
ITAGUAÇU;Vereador;Feminino;26;1;0;25
ITAGUAÇU DA BAHIA;Vereador;Masculino;26;9;0;17
ITAGUAÇU DA BAHIA;Vereador;Feminino;14;0;0;14
ITAGUAÍ;Vereador;Masculino;105;16;0;89
ITAGUAÍ;Vereador;Feminino;49;1;0;48
ITAGUAJÉ;Vereador;Masculino;22;9;0;13
ITAGUAJÉ;Vereador;Feminino;11;0;0;11
ITAGUARA;Vereador;Masculino;43;8;0;35
ITAGUARA;Vereador;Feminino;20;1;0;19
ITAGUARI;Vereador;Masculino;26;7;0;19
ITAGUARI;Vereador;Feminino;14;2;0;12
ITAGUARU;Vereador;Masculino;35;8;0;27
ITAGUARU;Vereador;Feminino;16;1;0;15
ITAGUATINS;Vereador;Masculino;27;7;0;20
ITAGUATINS;Vereador;Feminino;15;2;0;13
ITAÍ;Vereador;Masculino;78;7;0;71
ITAÍ;Vereador;Feminino;37;2;0;35
ITAÍBA;Vereador;Masculino;41;8;0;33
ITAÍBA;Vereador;Feminino;9;3;0;6
ITAIÇABA;Vereador;Masculino;25;7;0;18
ITAIÇABA;Vereador;Feminino;10;2;0;8
ITAINÓPOLIS;Vereador;Masculino;13;7;0;6
ITAINÓPOLIS;Vereador;Feminino;7;2;0;5
ITAIÓPOLIS;Vereador;Masculino;46;9;0;37
ITAIÓPOLIS;Vereador;Feminino;24;0;0;24
ITAIPAVA DO GRAJAÚ;Vereador;Masculino;47;9;0;38
ITAIPAVA DO GRAJAÚ;Vereador;Feminino;10;0;0;10
ITAIPÉ;Vereador;Masculino;35;8;0;27
ITAIPÉ;Vereador;Feminino;18;1;0;17
ITAIPULÂNDIA;Vereador;Masculino;35;7;0;28
ITAIPULÂNDIA;Vereador;Feminino;21;2;0;19
ITAITINGA;Vereador;Masculino;70;11;0;59
ITAITINGA;Vereador;Feminino;36;2;0;34
ITAITUBA;Vereador;Masculino;107;13;0;94
ITAITUBA;Vereador;Feminino;45;2;0;43
ITAJÁ;Vereador;Masculino;49;15;0;34
ITAJÁ;Vereador;Feminino;23;3;0;20
ITAJAÍ;Vereador;Masculino;176;17;0;159
ITAJAÍ;Vereador;Feminino;84;4;0;80
ITAJOBI;Vereador;Masculino;42;7;0;35
ITAJOBI;Vereador;Feminino;21;2;0;19
ITAJU;Vereador;Masculino;33;9;0;24
ITAJU;Vereador;Feminino;17;0;0;17
ITAJU DO COLÔNIA;Vereador;Masculino;30;9;0;21
ITAJU DO COLÔNIA;Vereador;Feminino;15;0;0;15
ITAJUBÁ;Vereador;Masculino;96;10;0;86
ITAJUBÁ;Vereador;Feminino;41;0;0;41
ITAJUÍPE;Vereador;Masculino;50;11;0;39
ITAJUÍPE;Vereador;Feminino;22;0;0;22
ITALVA;Vereador;Masculino;65;9;0;56
ITALVA;Vereador;Feminino;34;0;0;34
ITAMARAJU;Vereador;Masculino;97;14;0;83
ITAMARAJU;Vereador;Feminino;45;1;0;44
ITAMARANDIBA;Vereador;Masculino;60;13;0;47
ITAMARANDIBA;Vereador;Feminino;29;0;0;29
ITAMARATI;Vereador;Masculino;22;9;0;13
ITAMARATI;Vereador;Feminino;11;0;0;11
ITAMARATI DE MINAS;Vereador;Masculino;41;9;0;32
ITAMARATI DE MINAS;Vereador;Feminino;21;0;0;21
ITAMARI;Vereador;Masculino;29;8;0;21
ITAMARI;Vereador;Feminino;13;1;0;12
ITAMBACURI;Vereador;Masculino;83;10;0;73
ITAMBACURI;Vereador;Feminino;38;1;0;37
ITAMBARACÁ;Vereador;Masculino;41;9;0;32
ITAMBARACÁ;Vereador;Feminino;11;0;0;11
ITAMBÉ;Vereador;Masculino;166;25;0;141
ITAMBÉ;Vereador;Feminino;69;6;0;63
ITAMBÉ DO MATO DENTRO;Vereador;Masculino;28;8;0;20
ITAMBÉ DO MATO DENTRO;Vereador;Feminino;13;1;0;12
ITAMOGI;Vereador;Masculino;29;9;0;20
ITAMOGI;Vereador;Feminino;14;0;0;14
ITAMONTE;Vereador;Masculino;42;5;0;37
ITAMONTE;Vereador;Feminino;23;4;0;19
ITANAGRA;Vereador;Masculino;40;9;0;31
ITANAGRA;Vereador;Feminino;19;0;0;19
ITANHAÉM;Vereador;Masculino;137;10;0;127
ITANHAÉM;Vereador;Feminino;64;0;0;64
ITANHANDU;Vereador;Masculino;72;6;0;66
ITANHANDU;Vereador;Feminino;37;3;0;34
ITANHANGÁ;Vereador;Masculino;25;7;0;18
ITANHANGÁ;Vereador;Feminino;11;2;0;9
ITANHÉM;Vereador;Masculino;35;9;0;26
ITANHÉM;Vereador;Feminino;18;0;0;18
ITANHOMI;Vereador;Masculino;57;7;0;50
ITANHOMI;Vereador;Feminino;30;2;0;28
ITAOBIM;Vereador;Masculino;54;10;0;44
ITAOBIM;Vereador;Feminino;24;1;0;23
ITAOCA;Vereador;Masculino;21;9;0;12
ITAOCA;Vereador;Feminino;10;0;0;10
ITAOCARA;Vereador;Masculino;65;10;0;55
ITAOCARA;Vereador;Feminino;30;1;0;29
ITAPACI;Vereador;Masculino;60;9;0;51
ITAPACI;Vereador;Feminino;32;2;0;30
ITAPAGÉ;Vereador;Masculino;63;12;0;51
ITAPAGÉ;Vereador;Feminino;20;1;0;19
ITAPAGIPE;Vereador;Masculino;39;7;0;32
ITAPAGIPE;Vereador;Feminino;19;2;0;17
ITAPARICA;Vereador;Masculino;93;9;0;84
ITAPARICA;Vereador;Feminino;45;0;0;45
ITAPÉ;Vereador;Masculino;34;8;0;26
ITAPÉ;Vereador;Feminino;16;1;0;15
ITAPEBI;Vereador;Masculino;66;8;0;58
ITAPEBI;Vereador;Feminino;33;1;0;32
ITAPECERICA;Vereador;Masculino;80;11;0;69
ITAPECERICA;Vereador;Feminino;38;0;0;38
ITAPECERICA DA SERRA;Vereador;Masculino;124;12;0;112
ITAPECERICA DA SERRA;Vereador;Feminino;61;0;0;61
ITAPECURU MIRIM;Vereador;Masculino;107;11;0;96
ITAPECURU MIRIM;Vereador;Feminino;48;2;0;46
ITAPEJARA D'OESTE;Vereador;Masculino;21;9;0;12
ITAPEJARA D'OESTE;Vereador;Feminino;4;0;0;4
ITAPEMA;Vereador;Masculino;87;11;0;76
ITAPEMA;Vereador;Feminino;47;2;0;45
ITAPEMIRIM;Vereador;Masculino;83;10;0;73
ITAPEMIRIM;Vereador;Feminino;37;1;0;36
ITAPERUÇU;Vereador;Masculino;44;10;0;34
ITAPERUÇU;Vereador;Feminino;24;1;0;23
ITAPERUNA;Vereador;Masculino;145;13;0;132
ITAPERUNA;Vereador;Feminino;61;0;0;61
ITAPETIM;Vereador;Masculino;19;8;0;11
ITAPETIM;Vereador;Feminino;9;1;0;8
ITAPETINGA;Vereador;Masculino;102;12;0;90
ITAPETINGA;Vereador;Feminino;41;3;0;38
ITAPETININGA;Vereador;Masculino;135;17;0;118
ITAPETININGA;Vereador;Feminino;55;2;0;53
ITAPEVA;Vereador;Masculino;168;22;0;146
ITAPEVA;Vereador;Feminino;78;2;0;76
ITAPEVI;Vereador;Masculino;272;14;0;258
ITAPEVI;Vereador;Feminino;132;3;0;129
ITAPICURU;Vereador;Masculino;36;10;0;26
ITAPICURU;Vereador;Feminino;16;3;0;13
ITAPIPOCA;Vereador;Masculino;91;13;0;78
ITAPIPOCA;Vereador;Feminino;46;4;0;42
ITAPIRA;Vereador;Masculino;98;10;0;88
ITAPIRA;Vereador;Feminino;42;0;0;42
ITAPIRANGA;Vereador;Masculino;82;16;0;66
ITAPIRANGA;Vereador;Feminino;40;4;0;36
ITAPIRAPUÃ;Vereador;Masculino;43;6;0;37
ITAPIRAPUÃ;Vereador;Feminino;21;3;0;18
ITAPIRAPUÃ PAULISTA;Vereador;Masculino;20;9;0;11
ITAPIRAPUÃ PAULISTA;Vereador;Feminino;9;0;0;9
ITAPIRATINS;Vereador;Masculino;22;9;0;13
ITAPIRATINS;Vereador;Feminino;7;0;0;7
ITAPISSUMA;Vereador;Masculino;59;8;0;51
ITAPISSUMA;Vereador;Feminino;26;3;0;23
ITAPITANGA;Vereador;Masculino;30;7;0;23
ITAPITANGA;Vereador;Feminino;16;2;0;14
ITAPIÚNA;Vereador;Masculino;46;9;0;37
ITAPIÚNA;Vereador;Feminino;22;2;0;20
ITAPOÁ;Vereador;Masculino;64;8;0;56
ITAPOÁ;Vereador;Feminino;35;1;0;34
ITÁPOLIS;Vereador;Masculino;57;8;0;49
ITÁPOLIS;Vereador;Feminino;27;1;0;26
ITAPORÃ;Vereador;Masculino;48;11;0;37
ITAPORÃ;Vereador;Feminino;23;0;0;23
ITAPORÃ DO TOCANTINS;Vereador;Masculino;11;6;0;5
ITAPORÃ DO TOCANTINS;Vereador;Feminino;6;3;0;3
ITAPORANGA;Vereador;Masculino;94;19;0;75
ITAPORANGA;Vereador;Feminino;40;1;0;39
ITAPORANGA D'AJUDA;Vereador;Masculino;69;10;0;59
ITAPORANGA D'AJUDA;Vereador;Feminino;29;3;0;26
ITAPOROROCA;Vereador;Masculino;17;7;0;10
ITAPOROROCA;Vereador;Feminino;10;2;0;8
ITAPUÃ DO OESTE;Vereador;Masculino;50;8;0;42
ITAPUÃ DO OESTE;Vereador;Feminino;24;1;0;23
ITAPUCA;Vereador;Masculino;18;7;0;11
ITAPUCA;Vereador;Feminino;9;2;0;7
ITAPUÍ;Vereador;Masculino;55;7;0;48
ITAPUÍ;Vereador;Feminino;29;2;0;27
ITAPURA;Vereador;Masculino;39;7;0;32
ITAPURA;Vereador;Feminino;17;2;0;15
ITAPURANGA;Vereador;Masculino;63;8;0;55
ITAPURANGA;Vereador;Feminino;28;3;0;25
ITAQUAQUECETUBA;Vereador;Masculino;254;17;0;237
ITAQUAQUECETUBA;Vereador;Feminino;122;2;0;120
ITAQUARA;Vereador;Masculino;28;8;0;20
ITAQUARA;Vereador;Feminino;16;1;0;15
ITAQUI;Vereador;Masculino;59;8;0;51
ITAQUI;Vereador;Feminino;31;3;0;28
ITAQUIRAÍ;Vereador;Masculino;28;10;0;18
ITAQUIRAÍ;Vereador;Feminino;14;1;0;13
ITAQUITINGA;Vereador;Masculino;69;10;0;59
ITAQUITINGA;Vereador;Feminino;31;1;0;30
ITARANA;Vereador;Masculino;31;8;0;23
ITARANA;Vereador;Feminino;17;1;0;16
ITARANTIM;Vereador;Masculino;43;11;0;32
ITARANTIM;Vereador;Feminino;21;0;0;21
ITARARÉ;Vereador;Masculino;87;12;0;75
ITARARÉ;Vereador;Feminino;39;1;0;38
ITAREMA;Vereador;Masculino;40;13;0;27
ITAREMA;Vereador;Feminino;18;0;0;18
ITARIRI;Vereador;Masculino;73;10;0;63
ITARIRI;Vereador;Feminino;35;1;0;34
ITARUMÃ;Vereador;Masculino;23;8;0;15
ITARUMÃ;Vereador;Feminino;11;1;0;10
ITATI;Vereador;Masculino;16;9;0;7
ITATI;Vereador;Feminino;7;0;0;7
ITATIAIA;Vereador;Masculino;101;7;0;94
ITATIAIA;Vereador;Feminino;51;2;0;49
ITATIAIUÇU;Vereador;Masculino;54;7;0;47
ITATIAIUÇU;Vereador;Feminino;26;2;0;24
ITATIBA;Vereador;Masculino;164;17;0;147
ITATIBA;Vereador;Feminino;80;0;0;80
ITATIBA DO SUL;Vereador;Masculino;16;9;0;7
ITATIBA DO SUL;Vereador;Feminino;8;0;0;8
ITATIM;Vereador;Masculino;24;8;0;16
ITATIM;Vereador;Feminino;12;1;0;11
ITATINGA;Vereador;Masculino;52;8;0;44
ITATINGA;Vereador;Feminino;29;1;0;28
ITATIRA;Vereador;Masculino;37;9;0;28
ITATIRA;Vereador;Feminino;18;2;0;16
ITATUBA;Vereador;Masculino;27;7;0;20
ITATUBA;Vereador;Feminino;17;2;0;15
ITAÚ;Vereador;Masculino;14;8;0;6
ITAÚ;Vereador;Feminino;7;1;0;6
ITAÚ DE MINAS;Vereador;Masculino;47;7;0;40
ITAÚ DE MINAS;Vereador;Feminino;24;2;0;22
ITAÚBA;Vereador;Masculino;35;9;0;26
ITAÚBA;Vereador;Feminino;19;0;0;19
ITAUBAL;Vereador;Masculino;37;5;0;32
ITAUBAL;Vereador;Feminino;20;4;0;16
ITAUÇU;Vereador;Masculino;38;9;0;29
ITAUÇU;Vereador;Feminino;22;0;0;22
ITAUEIRA;Vereador;Masculino;26;7;0;19
ITAUEIRA;Vereador;Feminino;12;2;0;10
ITAÚNA;Vereador;Masculino;181;16;0;165
ITAÚNA;Vereador;Feminino;81;1;0;80
ITAÚNA DO SUL;Vereador;Masculino;24;9;0;15
ITAÚNA DO SUL;Vereador;Feminino;13;0;0;13
ITAVERAVA;Vereador;Masculino;37;9;0;28
ITAVERAVA;Vereador;Feminino;19;0;0;19
ITINGA;Vereador;Masculino;48;8;0;40
ITINGA;Vereador;Feminino;23;1;0;22
ITINGA DO MARANHÃO;Vereador;Masculino;54;9;0;45
ITINGA DO MARANHÃO;Vereador;Feminino;29;2;0;27
ITIQUIRA;Vereador;Masculino;54;9;0;45
ITIQUIRA;Vereador;Feminino;24;0;0;24
ITIRAPINA;Vereador;Masculino;84;8;0;76
ITIRAPINA;Vereador;Feminino;37;3;0;34
ITIRAPUÃ;Vereador;Masculino;47;8;0;39
ITIRAPUÃ;Vereador;Feminino;25;1;0;24
ITIRUÇU;Vereador;Masculino;40;9;0;31
ITIRUÇU;Vereador;Feminino;22;0;0;22
ITIÚBA;Vereador;Masculino;56;12;0;44
ITIÚBA;Vereador;Feminino;28;1;0;27
ITOBI;Vereador;Masculino;58;7;0;51
ITOBI;Vereador;Feminino;28;2;0;26
ITORORÓ;Vereador;Masculino;49;9;0;40
ITORORÓ;Vereador;Feminino;22;2;0;20
ITU;Vereador;Masculino;190;11;0;179
ITU;Vereador;Feminino;92;2;0;90
ITUAÇU;Vereador;Masculino;36;11;0;25
ITUAÇU;Vereador;Feminino;17;0;0;17
ITUBERÁ;Vereador;Masculino;72;9;0;63
ITUBERÁ;Vereador;Feminino;31;2;0;29
ITUETA;Vereador;Masculino;23;8;0;15
ITUETA;Vereador;Feminino;11;1;0;10
ITUIUTABA;Vereador;Masculino;129;17;0;112
ITUIUTABA;Vereador;Feminino;53;0;0;53
ITUMBIARA;Vereador;Masculino;97;16;0;81
ITUMBIARA;Vereador;Feminino;45;1;0;44
ITUMIRIM;Vereador;Masculino;48;8;0;40
ITUMIRIM;Vereador;Feminino;26;1;0;25
ITUPEVA;Vereador;Masculino;132;12;0;120
ITUPEVA;Vereador;Feminino;56;1;0;55
ITUPIRANGA;Vereador;Masculino;106;12;0;94
ITUPIRANGA;Vereador;Feminino;45;1;0;44
ITUPORANGA;Vereador;Masculino;28;11;0;17
ITUPORANGA;Vereador;Feminino;13;0;0;13
ITURAMA;Vereador;Masculino;85;12;0;73
ITURAMA;Vereador;Feminino;38;1;0;37
ITUTINGA;Vereador;Masculino;27;8;0;19
ITUTINGA;Vereador;Feminino;16;1;0;15
ITUVERAVA;Vereador;Masculino;67;11;0;56
ITUVERAVA;Vereador;Feminino;27;2;0;25
IUIU;Vereador;Masculino;22;7;0;15
IUIU;Vereador;Feminino;10;2;0;8
IÚNA;Vereador;Masculino;96;11;0;85
IÚNA;Vereador;Feminino;41;0;0;41
IVAÍ;Vereador;Masculino;35;9;0;26
IVAÍ;Vereador;Feminino;17;0;0;17
IVAIPORÃ;Vereador;Masculino;71;8;0;63
IVAIPORÃ;Vereador;Feminino;34;1;0;33
IVATÉ;Vereador;Masculino;40;9;0;31
IVATÉ;Vereador;Feminino;16;0;0;16
IVATUBA;Vereador;Masculino;20;6;0;14
IVATUBA;Vereador;Feminino;10;3;0;7
IVINHEMA;Vereador;Masculino;68;10;0;58
IVINHEMA;Vereador;Feminino;32;1;0;31
IVOLÂNDIA;Vereador;Masculino;25;8;0;17
IVOLÂNDIA;Vereador;Feminino;12;1;0;11
IVORÁ;Vereador;Masculino;22;8;0;14
IVORÁ;Vereador;Feminino;11;1;0;10
IVOTI;Vereador;Masculino;39;6;0;33
IVOTI;Vereador;Feminino;22;3;0;19
JABOATÃO DOS GUARARAPES;Vereador;Masculino;481;26;0;455
JABOATÃO DOS GUARARAPES;Vereador;Feminino;190;1;0;189
JABORÁ;Vereador;Masculino;18;7;0;11
JABORÁ;Vereador;Feminino;8;2;0;6
JABORANDI;Vereador;Masculino;59;16;0;43
JABORANDI;Vereador;Feminino;29;2;0;27
JABOTI;Vereador;Masculino;19;8;0;11
JABOTI;Vereador;Feminino;9;1;0;8
JABOTICABA;Vereador;Masculino;15;8;0;7
JABOTICABA;Vereador;Feminino;7;1;0;6
JABOTICABAL;Vereador;Masculino;149;11;0;138
JABOTICABAL;Vereador;Feminino;71;2;0;69
JABOTICATUBAS;Vereador;Masculino;76;10;0;66
JABOTICATUBAS;Vereador;Feminino;38;1;0;37
JAÇANÃ;Vereador;Masculino;16;7;0;9
JAÇANÃ;Vereador;Feminino;8;2;0;6
JACARACI;Vereador;Masculino;36;8;0;28
JACARACI;Vereador;Feminino;17;1;0;16
JACARAÚ;Vereador;Masculino;27;9;0;18
JACARAÚ;Vereador;Feminino;14;0;0;14
JACARÉ DOS HOMENS;Vereador;Masculino;15;8;0;7
JACARÉ DOS HOMENS;Vereador;Feminino;7;1;0;6
JACAREACANGA;Vereador;Masculino;48;10;0;38
JACAREACANGA;Vereador;Feminino;20;1;0;19
JACAREÍ;Vereador;Masculino;125;11;0;114
JACAREÍ;Vereador;Feminino;57;2;0;55
JACAREZINHO;Vereador;Masculino;87;8;0;79
JACAREZINHO;Vereador;Feminino;44;1;0;43
JACI;Vereador;Masculino;32;8;0;24
JACI;Vereador;Feminino;15;1;0;14
JACIARA;Vereador;Masculino;60;11;0;49
JACIARA;Vereador;Feminino;27;0;0;27
JACINTO;Vereador;Masculino;45;9;0;36
JACINTO;Vereador;Feminino;17;0;0;17
JACINTO MACHADO;Vereador;Masculino;23;8;0;15
JACINTO MACHADO;Vereador;Feminino;12;1;0;11
JACOBINA;Vereador;Masculino;83;13;0;70
JACOBINA;Vereador;Feminino;38;2;0;36
JACOBINA DO PIAUÍ;Vereador;Masculino;17;8;0;9
JACOBINA DO PIAUÍ;Vereador;Feminino;9;1;0;8
JACUÍ;Vereador;Masculino;24;9;0;15
JACUÍ;Vereador;Feminino;11;0;0;11
JACUÍPE;Vereador;Masculino;38;8;0;30
JACUÍPE;Vereador;Feminino;21;1;0;20
JACUIZINHO;Vereador;Masculino;17;7;0;10
JACUIZINHO;Vereador;Feminino;9;2;0;7
JACUNDÁ;Vereador;Masculino;75;9;0;66
JACUNDÁ;Vereador;Feminino;37;4;0;33
JACUPIRANGA;Vereador;Masculino;56;8;0;48
JACUPIRANGA;Vereador;Feminino;28;1;0;27
JACUTINGA;Vereador;Masculino;66;16;0;50
JACUTINGA;Vereador;Feminino;35;4;0;31
JAGUAPITÃ;Vereador;Masculino;36;5;0;31
JAGUAPITÃ;Vereador;Feminino;18;4;0;14
JAGUAQUARA;Vereador;Masculino;77;13;0;64
JAGUAQUARA;Vereador;Feminino;40;2;0;38
JAGUARAÇU;Vereador;Masculino;17;7;0;10
JAGUARAÇU;Vereador;Feminino;11;2;0;9
JAGUARÃO;Vereador;Masculino;55;7;0;48
JAGUARÃO;Vereador;Feminino;31;2;0;29
JAGUARARI;Vereador;Masculino;62;11;0;51
JAGUARARI;Vereador;Feminino;33;2;0;31
JAGUARÉ;Vereador;Masculino;49;10;0;39
JAGUARÉ;Vereador;Feminino;24;1;0;23
JAGUARETAMA;Vereador;Masculino;27;9;0;18
JAGUARETAMA;Vereador;Feminino;13;2;0;11
JAGUARI;Vereador;Masculino;28;6;0;22
JAGUARI;Vereador;Feminino;15;3;0;12
JAGUARIAÍVA;Vereador;Masculino;74;10;0;64
JAGUARIAÍVA;Vereador;Feminino;33;3;0;30
JAGUARIBARA;Vereador;Masculino;23;7;0;16
JAGUARIBARA;Vereador;Feminino;15;2;0;13
JAGUARIBE;Vereador;Masculino;55;13;0;42
JAGUARIBE;Vereador;Feminino;30;0;0;30
JAGUARIPE;Vereador;Masculino;48;9;0;39
JAGUARIPE;Vereador;Feminino;22;2;0;20
JAGUARIÚNA;Vereador;Masculino;103;12;0;91
JAGUARIÚNA;Vereador;Feminino;49;1;0;48
JAGUARUANA;Vereador;Masculino;53;11;0;42
JAGUARUANA;Vereador;Feminino;24;2;0;22
JAGUARUNA;Vereador;Masculino;33;10;0;23
JAGUARUNA;Vereador;Feminino;16;1;0;15
JAÍBA;Vereador;Masculino;99;12;0;87
JAÍBA;Vereador;Feminino;46;1;0;45
JAICÓS;Vereador;Masculino;24;7;0;17
JAICÓS;Vereador;Feminino;13;4;0;9
JALES;Vereador;Masculino;87;9;0;78
JALES;Vereador;Feminino;37;1;0;36
JAMBEIRO;Vereador;Masculino;63;8;0;55
JAMBEIRO;Vereador;Feminino;34;1;0;33
JAMPRUCA;Vereador;Masculino;34;8;0;26
JAMPRUCA;Vereador;Feminino;17;1;0;16
JANAÚBA;Vereador;Masculino;106;15;0;91
JANAÚBA;Vereador;Feminino;47;0;0;47
JANDAIA;Vereador;Masculino;24;8;0;16
JANDAIA;Vereador;Feminino;12;1;0;11
JANDAIA DO SUL;Vereador;Masculino;71;7;0;64
JANDAIA DO SUL;Vereador;Feminino;34;2;0;32
JANDAÍRA;Vereador;Masculino;52;17;0;35
JANDAÍRA;Vereador;Feminino;25;1;0;24
JANDIRA;Vereador;Masculino;170;12;0;158
JANDIRA;Vereador;Feminino;73;1;0;72
JANDUÍS;Vereador;Masculino;17;7;0;10
JANDUÍS;Vereador;Feminino;8;2;0;6
JANGADA;Vereador;Masculino;27;9;0;18
JANGADA;Vereador;Feminino;11;0;0;11
JANIÓPOLIS;Vereador;Masculino;28;8;0;20
JANIÓPOLIS;Vereador;Feminino;13;1;0;12
JANUÁRIA;Vereador;Masculino;110;14;0;96
JANUÁRIA;Vereador;Feminino;42;1;0;41
JAPARAÍBA;Vereador;Masculino;50;7;0;43
JAPARAÍBA;Vereador;Feminino;26;2;0;24
JAPARATINGA;Vereador;Masculino;29;7;0;22
JAPARATINGA;Vereador;Feminino;16;2;0;14
JAPARATUBA;Vereador;Masculino;82;9;0;73
JAPARATUBA;Vereador;Feminino;39;2;0;37
JAPERI;Vereador;Masculino;160;11;0;149
JAPERI;Vereador;Feminino;73;0;0;73
JAPI;Vereador;Masculino;27;7;0;20
JAPI;Vereador;Feminino;10;2;0;8
JAPIRA;Vereador;Masculino;43;8;0;35
JAPIRA;Vereador;Feminino;19;1;0;18
JAPOATÃ;Vereador;Masculino;32;7;0;25
JAPOATÃ;Vereador;Feminino;14;2;0;12
JAPONVAR;Vereador;Masculino;48;9;0;39
JAPONVAR;Vereador;Feminino;20;0;0;20
JAPORÃ;Vereador;Masculino;71;6;0;65
JAPORÃ;Vereador;Feminino;39;3;0;36
JAPURÁ;Vereador;Masculino;73;15;0;58
JAPURÁ;Vereador;Feminino;46;3;0;43
JAQUEIRA;Vereador;Masculino;51;8;0;43
JAQUEIRA;Vereador;Feminino;22;1;0;21
JAQUIRANA;Vereador;Masculino;24;7;0;17
JAQUIRANA;Vereador;Feminino;12;2;0;10
JARAGUÁ;Vereador;Masculino;72;12;0;60
JARAGUÁ;Vereador;Feminino;28;1;0;27
JARAGUÁ DO SUL;Vereador;Masculino;115;10;0;105
JARAGUÁ DO SUL;Vereador;Feminino;51;1;0;50
JARAGUARI;Vereador;Masculino;38;9;0;29
JARAGUARI;Vereador;Feminino;17;0;0;17
JARAMATAIA;Vereador;Masculino;19;5;0;14
JARAMATAIA;Vereador;Feminino;11;4;0;7
JARDIM;Vereador;Masculino;55;15;0;40
JARDIM;Vereador;Feminino;27;7;0;20
JARDIM ALEGRE;Vereador;Masculino;44;8;0;36
JARDIM ALEGRE;Vereador;Feminino;22;1;0;21
JARDIM DE ANGICOS;Vereador;Masculino;21;8;0;13
JARDIM DE ANGICOS;Vereador;Feminino;10;1;0;9
JARDIM DE PIRANHAS;Vereador;Masculino;20;8;0;12
JARDIM DE PIRANHAS;Vereador;Feminino;10;1;0;9
JARDIM DO MULATO;Vereador;Masculino;12;7;0;5
JARDIM DO MULATO;Vereador;Feminino;6;2;0;4
JARDIM DO SERIDÓ;Vereador;Masculino;27;8;0;19
JARDIM DO SERIDÓ;Vereador;Feminino;15;1;0;14
JARDIM OLINDA;Vereador;Masculino;17;6;0;11
JARDIM OLINDA;Vereador;Feminino;7;3;0;4
JARDINÓPOLIS;Vereador;Masculino;113;21;0;92
JARDINÓPOLIS;Vereador;Feminino;52;1;0;51
JARI;Vereador;Masculino;20;9;0;11
JARI;Vereador;Feminino;10;0;0;10
JARINU;Vereador;Masculino;78;9;0;69
JARINU;Vereador;Feminino;38;2;0;36
JARU;Vereador;Masculino;103;13;0;90
JARU;Vereador;Feminino;29;2;0;27
JATAÍ;Vereador;Masculino;76;10;0;66
JATAÍ;Vereador;Feminino;33;0;0;33
JATAIZINHO;Vereador;Masculino;59;9;0;50
JATAIZINHO;Vereador;Feminino;26;0;0;26
JATAÚBA;Vereador;Masculino;33;8;0;25
JATAÚBA;Vereador;Feminino;4;3;0;1
JATEÍ;Vereador;Masculino;21;6;0;15
JATEÍ;Vereador;Feminino;11;3;0;8
JATI;Vereador;Masculino;20;6;0;14
JATI;Vereador;Feminino;10;3;0;7
JATOBÁ;Vereador;Masculino;51;17;0;34
JATOBÁ;Vereador;Feminino;25;1;0;24
JATOBÁ DO PIAUÍ;Vereador;Masculino;37;8;0;29
JATOBÁ DO PIAUÍ;Vereador;Feminino;15;1;0;14
JAÚ;Vereador;Masculino;157;16;0;141
JAÚ;Vereador;Feminino;74;1;0;73
JAÚ DO TOCANTINS;Vereador;Masculino;23;5;0;18
JAÚ DO TOCANTINS;Vereador;Feminino;12;4;0;8
JAUPACI;Vereador;Masculino;18;8;0;10
JAUPACI;Vereador;Feminino;8;1;0;7
JAURU;Vereador;Masculino;44;8;0;36
JAURU;Vereador;Feminino;21;1;0;20
JECEABA;Vereador;Masculino;47;9;0;38
JECEABA;Vereador;Feminino;23;0;0;23
JENIPAPO DE MINAS;Vereador;Masculino;18;6;0;12
JENIPAPO DE MINAS;Vereador;Feminino;9;3;0;6
JENIPAPO DOS VIEIRAS;Vereador;Masculino;37;9;0;28
JENIPAPO DOS VIEIRAS;Vereador;Feminino;17;2;0;15
JEQUERI;Vereador;Masculino;57;8;0;49
JEQUERI;Vereador;Feminino;30;1;0;29
JEQUIÁ DA PRAIA;Vereador;Masculino;22;8;0;14
JEQUIÁ DA PRAIA;Vereador;Feminino;11;1;0;10
JEQUIÉ;Vereador;Masculino;169;18;0;151
JEQUIÉ;Vereador;Feminino;76;1;0;75
JEQUITAÍ;Vereador;Masculino;34;8;0;26
JEQUITAÍ;Vereador;Feminino;17;1;0;16
JEQUITIBÁ;Vereador;Masculino;44;8;0;36
JEQUITIBÁ;Vereador;Feminino;22;1;0;21
JEQUITINHONHA;Vereador;Masculino;75;10;0;65
JEQUITINHONHA;Vereador;Feminino;37;1;0;36
JEREMOABO;Vereador;Masculino;32;11;0;21
JEREMOABO;Vereador;Feminino;17;2;0;15
JERICÓ;Vereador;Masculino;24;8;0;16
JERICÓ;Vereador;Feminino;13;1;0;12
JERIQUARA;Vereador;Masculino;16;9;0;7
JERIQUARA;Vereador;Feminino;8;0;0;8
JERÔNIMO MONTEIRO;Vereador;Masculino;36;9;0;27
JERÔNIMO MONTEIRO;Vereador;Feminino;13;0;0;13
JERUMENHA;Vereador;Masculino;32;7;0;25
JERUMENHA;Vereador;Feminino;15;2;0;13
JESUÂNIA;Vereador;Masculino;45;6;0;39
JESUÂNIA;Vereador;Feminino;24;3;0;21
JESUÍTAS;Vereador;Masculino;30;8;0;22
JESUÍTAS;Vereador;Feminino;16;1;0;15
JESÚPOLIS;Vereador;Masculino;18;8;0;10
JESÚPOLIS;Vereador;Feminino;11;1;0;10
JIJOCA DE JERICOACOARA;Vereador;Masculino;38;11;0;27
JIJOCA DE JERICOACOARA;Vereador;Feminino;20;0;0;20
JI-PARANÁ;Vereador;Masculino;169;14;0;155
JI-PARANÁ;Vereador;Feminino;62;3;0;59
JIQUIRIÇÁ;Vereador;Masculino;33;9;0;24
JIQUIRIÇÁ;Vereador;Feminino;18;0;0;18
JITAÚNA;Vereador;Masculino;31;8;0;23
JITAÚNA;Vereador;Feminino;16;1;0;15
JOAÇABA;Vereador;Masculino;56;8;0;48
JOAÇABA;Vereador;Feminino;29;1;0;28
JOAÍMA;Vereador;Masculino;47;8;0;39
JOAÍMA;Vereador;Feminino;25;1;0;24
JOANÉSIA;Vereador;Masculino;49;8;0;41
JOANÉSIA;Vereador;Feminino;26;1;0;25
JOANÓPOLIS;Vereador;Masculino;53;9;0;44
JOANÓPOLIS;Vereador;Feminino;24;0;0;24
JOÃO ALFREDO;Vereador;Masculino;34;10;0;24
JOÃO ALFREDO;Vereador;Feminino;16;3;0;13
JOÃO CÂMARA;Vereador;Masculino;36;9;0;27
JOÃO CÂMARA;Vereador;Feminino;26;0;0;26
JOÃO COSTA;Vereador;Masculino;23;8;0;15
JOÃO COSTA;Vereador;Feminino;11;1;0;10
JOÃO DIAS;Vereador;Masculino;9;5;0;4
JOÃO DIAS;Vereador;Feminino;5;4;0;1
JOÃO DOURADO;Vereador;Masculino;23;7;0;16
JOÃO DOURADO;Vereador;Feminino;10;4;0;6
JOÃO LISBOA;Vereador;Masculino;61;9;0;52
JOÃO LISBOA;Vereador;Feminino;31;2;0;29
JOÃO MONLEVADE;Vereador;Masculino;99;11;0;88
JOÃO MONLEVADE;Vereador;Feminino;45;0;0;45
JOÃO NEIVA;Vereador;Masculino;63;9;0;54
JOÃO NEIVA;Vereador;Feminino;27;2;0;25
JOÃO PESSOA;Vereador;Masculino;393;25;0;368
JOÃO PESSOA;Vereador;Feminino;163;2;0;161
JOÃO PINHEIRO;Vereador;Masculino;82;13;0;69
JOÃO PINHEIRO;Vereador;Feminino;39;0;0;39
JOÃO RAMALHO;Vereador;Masculino;38;7;0;31
JOÃO RAMALHO;Vereador;Feminino;28;2;0;26
JOAQUIM FELÍCIO;Vereador;Masculino;33;8;0;25
JOAQUIM FELÍCIO;Vereador;Feminino;17;1;0;16
JOAQUIM GOMES;Vereador;Masculino;34;10;0;24
JOAQUIM GOMES;Vereador;Feminino;17;1;0;16
JOAQUIM NABUCO;Vereador;Masculino;40;6;0;34
JOAQUIM NABUCO;Vereador;Feminino;20;3;0;17
JOAQUIM PIRES;Vereador;Masculino;23;9;0;14
JOAQUIM PIRES;Vereador;Feminino;11;0;0;11
JOAQUIM TÁVORA;Vereador;Masculino;55;9;0;46
JOAQUIM TÁVORA;Vereador;Feminino;14;0;0;14
JOCA CLAUDINO;Vereador;Masculino;15;9;0;6
JOCA CLAUDINO;Vereador;Feminino;7;0;0;7
JOCA MARQUES;Vereador;Masculino;17;9;0;8
JOCA MARQUES;Vereador;Feminino;9;0;0;9
JÓIA;Vereador;Masculino;22;9;0;13
JÓIA;Vereador;Feminino;13;0;0;13
JOINVILLE;Vereador;Masculino;233;18;0;215
JOINVILLE;Vereador;Feminino;103;1;0;102
JORDÂNIA;Vereador;Masculino;41;5;0;36
JORDÂNIA;Vereador;Feminino;21;4;0;17
JORDÃO;Vereador;Masculino;31;7;0;24
JORDÃO;Vereador;Feminino;15;2;0;13
JOSÉ BOITEUX;Vereador;Masculino;21;7;0;14
JOSÉ BOITEUX;Vereador;Feminino;11;2;0;9
JOSÉ BONIFÁCIO;Vereador;Masculino;87;9;0;78
JOSÉ BONIFÁCIO;Vereador;Feminino;45;0;0;45
JOSÉ DA PENHA;Vereador;Masculino;12;7;0;5
JOSÉ DA PENHA;Vereador;Feminino;7;2;0;5
JOSÉ DE FREITAS;Vereador;Masculino;79;12;0;67
JOSÉ DE FREITAS;Vereador;Feminino;32;1;0;31
JOSÉ GONÇALVES DE MINAS;Vereador;Masculino;37;8;0;29
JOSÉ GONÇALVES DE MINAS;Vereador;Feminino;18;1;0;17
JOSÉ RAYDAN;Vereador;Masculino;35;7;0;28
JOSÉ RAYDAN;Vereador;Feminino;17;2;0;15
JOSELÂNDIA;Vereador;Masculino;20;9;0;11
JOSELÂNDIA;Vereador;Feminino;9;2;0;7
JOSENÓPOLIS;Vereador;Masculino;24;8;0;16
JOSENÓPOLIS;Vereador;Feminino;12;1;0;11
JOVIÂNIA;Vereador;Masculino;22;7;0;15
JOVIÂNIA;Vereador;Feminino;14;2;0;12
JUARA;Vereador;Masculino;59;8;0;51
JUARA;Vereador;Feminino;29;1;0;28
JUAREZ TÁVORA;Vereador;Masculino;28;9;0;19
JUAREZ TÁVORA;Vereador;Feminino;15;0;0;15
JUARINA;Vereador;Masculino;25;7;0;18
JUARINA;Vereador;Feminino;13;2;0;11
JUATUBA;Vereador;Masculino;88;8;0;80
JUATUBA;Vereador;Feminino;45;1;0;44
JUAZEIRINHO;Vereador;Masculino;61;5;0;56
JUAZEIRINHO;Vereador;Feminino;30;6;0;24
JUAZEIRO;Vereador;Masculino;181;19;0;162
JUAZEIRO;Vereador;Feminino;79;2;0;77
JUAZEIRO DO NORTE;Vereador;Masculino;165;18;0;147
JUAZEIRO DO NORTE;Vereador;Feminino;74;3;0;71
JUAZEIRO DO PIAUÍ;Vereador;Masculino;19;7;0;12
JUAZEIRO DO PIAUÍ;Vereador;Feminino;9;2;0;7
JUCÁS;Vereador;Masculino;21;9;0;12
JUCÁS;Vereador;Feminino;10;2;0;8
JUCATI;Vereador;Masculino;23;9;0;14
JUCATI;Vereador;Feminino;10;0;0;10
JUCURUÇU;Vereador;Masculino;49;8;0;41
JUCURUÇU;Vereador;Feminino;26;1;0;25
JUCURUTU;Vereador;Masculino;20;10;0;10
JUCURUTU;Vereador;Feminino;10;1;0;9
JUÍNA;Vereador;Masculino;47;9;0;38
JUÍNA;Vereador;Feminino;22;4;0;18
JUIZ DE FORA;Vereador;Masculino;298;18;0;280
JUIZ DE FORA;Vereador;Feminino;136;1;0;135
JÚLIO BORGES;Vereador;Masculino;14;7;0;7
JÚLIO BORGES;Vereador;Feminino;7;2;0;5
JÚLIO DE CASTILHOS;Vereador;Masculino;43;10;0;33
JÚLIO DE CASTILHOS;Vereador;Feminino;21;1;0;20
JÚLIO MESQUITA;Vereador;Masculino;16;7;0;9
JÚLIO MESQUITA;Vereador;Feminino;8;2;0;6
JUMIRIM;Vereador;Masculino;33;7;0;26
JUMIRIM;Vereador;Feminino;22;2;0;20
JUNCO DO MARANHÃO;Vereador;Masculino;33;7;0;26
JUNCO DO MARANHÃO;Vereador;Feminino;15;2;0;13
JUNCO DO SERIDÓ;Vereador;Masculino;21;9;0;12
JUNCO DO SERIDÓ;Vereador;Feminino;10;0;0;10
JUNDIÁ;Vereador;Masculino;54;13;0;41
JUNDIÁ;Vereador;Feminino;29;5;0;24
JUNDIAÍ;Vereador;Masculino;273;18;0;255
JUNDIAÍ;Vereador;Feminino;134;1;0;133
JUNDIAÍ DO SUL;Vereador;Masculino;21;8;0;13
JUNDIAÍ DO SUL;Vereador;Feminino;7;1;0;6
JUNQUEIRO;Vereador;Masculino;26;9;0;17
JUNQUEIRO;Vereador;Feminino;11;2;0;9
JUNQUEIRÓPOLIS;Vereador;Masculino;45;6;0;39
JUNQUEIRÓPOLIS;Vereador;Feminino;21;3;0;18
JUPI;Vereador;Masculino;31;7;0;24
JUPI;Vereador;Feminino;16;2;0;14
JUPIÁ;Vereador;Masculino;20;7;0;13
JUPIÁ;Vereador;Feminino;10;2;0;8
JUQUIÁ;Vereador;Masculino;107;9;0;98
JUQUIÁ;Vereador;Feminino;47;2;0;45
JUQUITIBA;Vereador;Masculino;97;11;0;86
JUQUITIBA;Vereador;Feminino;45;0;0;45
JURAMENTO;Vereador;Masculino;47;9;0;38
JURAMENTO;Vereador;Feminino;22;0;0;22
JURANDA;Vereador;Masculino;24;9;0;15
JURANDA;Vereador;Feminino;9;0;0;9
JUREMA;Vereador;Masculino;36;14;0;22
JUREMA;Vereador;Feminino;18;4;0;14
JURIPIRANGA;Vereador;Masculino;22;8;0;14
JURIPIRANGA;Vereador;Feminino;12;1;0;11
JURU;Vereador;Masculino;18;7;0;11
JURU;Vereador;Feminino;15;2;0;13
JURUÁ;Vereador;Masculino;35;9;0;26
JURUÁ;Vereador;Feminino;17;0;0;17
JURUAIA;Vereador;Masculino;32;9;0;23
JURUAIA;Vereador;Feminino;16;0;0;16
JURUENA;Vereador;Masculino;40;9;0;31
JURUENA;Vereador;Feminino;21;0;0;21
JURUTI;Vereador;Masculino;76;11;0;65
JURUTI;Vereador;Feminino;33;2;0;31
JUSCIMEIRA;Vereador;Masculino;42;8;0;34
JUSCIMEIRA;Vereador;Feminino;20;1;0;19
JUSSARA;Vereador;Masculino;117;26;0;91
JUSSARA;Vereador;Feminino;62;5;0;57
JUSSARI;Vereador;Masculino;23;8;0;15
JUSSARI;Vereador;Feminino;12;1;0;11
JUSSIAPE;Vereador;Masculino;20;7;0;13
JUSSIAPE;Vereador;Feminino;9;2;0;7
JUTAÍ;Vereador;Masculino;51;10;0;41
JUTAÍ;Vereador;Feminino;25;1;0;24
JUTI;Vereador;Masculino;24;6;0;18
JUTI;Vereador;Feminino;12;3;0;9
JUVENÍLIA;Vereador;Masculino;23;9;0;14
JUVENÍLIA;Vereador;Feminino;10;0;0;10
KALORÉ;Vereador;Masculino;20;7;0;13
KALORÉ;Vereador;Feminino;9;2;0;7
LÁBREA;Vereador;Masculino;58;7;0;51
LÁBREA;Vereador;Feminino;30;2;0;28
LACERDÓPOLIS;Vereador;Masculino;16;8;0;8
LACERDÓPOLIS;Vereador;Feminino;7;1;0;6
LADAINHA;Vereador;Masculino;50;11;0;39
LADAINHA;Vereador;Feminino;25;0;0;25
LADÁRIO;Vereador;Masculino;99;10;0;89
LADÁRIO;Vereador;Feminino;49;1;0;48
LAFAIETE COUTINHO;Vereador;Masculino;26;9;0;17
LAFAIETE COUTINHO;Vereador;Feminino;15;0;0;15
LAGAMAR;Vereador;Masculino;34;9;0;25
LAGAMAR;Vereador;Feminino;14;0;0;14
LAGARTO;Vereador;Masculino;98;16;0;82
LAGARTO;Vereador;Feminino;38;1;0;37
LAGES;Vereador;Masculino;145;18;0;127
LAGES;Vereador;Feminino;69;1;0;68
LAGO DA PEDRA;Vereador;Masculino;39;11;0;28
LAGO DA PEDRA;Vereador;Feminino;22;2;0;20
LAGO DO JUNCO;Vereador;Masculino;21;6;0;15
LAGO DO JUNCO;Vereador;Feminino;10;3;0;7
LAGO DOS RODRIGUES;Vereador;Masculino;22;8;0;14
LAGO DOS RODRIGUES;Vereador;Feminino;13;1;0;12
LAGO VERDE;Vereador;Masculino;57;8;0;49
LAGO VERDE;Vereador;Feminino;27;3;0;24
LAGOA;Vereador;Masculino;15;7;0;8
LAGOA;Vereador;Feminino;8;2;0;6
LAGOA ALEGRE;Vereador;Masculino;35;7;0;28
LAGOA ALEGRE;Vereador;Feminino;17;2;0;15
LAGOA BONITA DO SUL;Vereador;Masculino;17;8;0;9
LAGOA BONITA DO SUL;Vereador;Feminino;10;1;0;9
LAGOA DA CANOA;Vereador;Masculino;43;7;0;36
LAGOA DA CANOA;Vereador;Feminino;24;2;0;22
LAGOA DA CONFUSÃO;Vereador;Masculino;31;7;0;24
LAGOA DA CONFUSÃO;Vereador;Feminino;16;2;0;14
LAGOA DA PRATA;Vereador;Masculino;97;7;0;90
LAGOA DA PRATA;Vereador;Feminino;50;2;0;48
LAGOA D'ANTA;Vereador;Masculino;15;8;0;7
LAGOA D'ANTA;Vereador;Feminino;13;1;0;12
LAGOA DE DENTRO;Vereador;Masculino;24;7;0;17
LAGOA DE DENTRO;Vereador;Feminino;12;2;0;10
LAGOA DE ITAENGA;Vereador;Masculino;32;9;0;23
LAGOA DE ITAENGA;Vereador;Feminino;14;2;0;12
LAGOA DE PEDRAS;Vereador;Masculino;24;8;0;16
LAGOA DE PEDRAS;Vereador;Feminino;13;1;0;12
LAGOA DE SÃO FRANCISCO;Vereador;Masculino;19;8;0;11
LAGOA DE SÃO FRANCISCO;Vereador;Feminino;8;1;0;7
LAGOA DE VELHOS;Vereador;Masculino;24;6;0;18
LAGOA DE VELHOS;Vereador;Feminino;12;3;0;9
LAGOA DO BARRO DO PIAUÍ;Vereador;Masculino;16;9;0;7
LAGOA DO BARRO DO PIAUÍ;Vereador;Feminino;8;0;0;8
LAGOA DO CARRO;Vereador;Masculino;77;9;0;68
LAGOA DO CARRO;Vereador;Feminino;29;2;0;27
LAGOA DO MATO;Vereador;Masculino;10;7;0;3
LAGOA DO MATO;Vereador;Feminino;5;2;0;3
LAGOA DO OURO;Vereador;Masculino;31;8;0;23
LAGOA DO OURO;Vereador;Feminino;16;1;0;15
LAGOA DO PIAUÍ;Vereador;Masculino;23;9;0;14
LAGOA DO PIAUÍ;Vereador;Feminino;11;0;0;11
LAGOA DO SÍTIO;Vereador;Masculino;15;9;0;6
LAGOA DO SÍTIO;Vereador;Feminino;7;0;0;7
LAGOA DO TOCANTINS;Vereador;Masculino;28;9;0;19
LAGOA DO TOCANTINS;Vereador;Feminino;11;0;0;11
LAGOA DOS GATOS;Vereador;Masculino;22;9;0;13
LAGOA DOS GATOS;Vereador;Feminino;11;0;0;11
LAGOA DOS PATOS;Vereador;Masculino;28;7;0;21
LAGOA DOS PATOS;Vereador;Feminino;15;2;0;13
LAGOA DOS TRÊS CANTOS;Vereador;Masculino;17;5;0;12
LAGOA DOS TRÊS CANTOS;Vereador;Feminino;9;4;0;5
LAGOA DOURADA;Vereador;Masculino;33;9;0;24
LAGOA DOURADA;Vereador;Feminino;16;0;0;16
LAGOA FORMOSA;Vereador;Masculino;24;11;0;13
LAGOA FORMOSA;Vereador;Feminino;10;0;0;10
LAGOA GRANDE;Vereador;Masculino;75;17;0;58
LAGOA GRANDE;Vereador;Feminino;36;3;0;33
LAGOA GRANDE DO MARANHÃO;Vereador;Masculino;32;8;0;24
LAGOA GRANDE DO MARANHÃO;Vereador;Feminino;18;1;0;17
LAGOA NOVA;Vereador;Masculino;23;9;0;14
LAGOA NOVA;Vereador;Feminino;12;0;0;12
LAGOA REAL;Vereador;Masculino;23;7;0;16
LAGOA REAL;Vereador;Feminino;14;2;0;12
LAGOA SALGADA;Vereador;Masculino;26;6;0;20
LAGOA SALGADA;Vereador;Feminino;14;3;0;11
LAGOA SANTA;Vereador;Masculino;119;16;0;103
LAGOA SANTA;Vereador;Feminino;60;2;0;58
LAGOA SECA;Vereador;Masculino;27;10;0;17
LAGOA SECA;Vereador;Feminino;12;1;0;11
LAGOA VERMELHA;Vereador;Masculino;41;8;0;33
LAGOA VERMELHA;Vereador;Feminino;22;1;0;21
LAGOÃO;Vereador;Masculino;20;9;0;11
LAGOÃO;Vereador;Feminino;10;0;0;10
LAGOINHA;Vereador;Masculino;32;8;0;24
LAGOINHA;Vereador;Feminino;15;1;0;14
LAGOINHA DO PIAUÍ;Vereador;Masculino;21;7;0;14
LAGOINHA DO PIAUÍ;Vereador;Feminino;10;2;0;8
LAGUNA;Vereador;Masculino;68;13;0;55
LAGUNA;Vereador;Feminino;30;0;0;30
LAGUNA CARAPÃ;Vereador;Masculino;29;8;0;21
LAGUNA CARAPÃ;Vereador;Feminino;15;1;0;14
LAJE;Vereador;Masculino;46;9;0;37
LAJE;Vereador;Feminino;22;2;0;20
LAJE DO MURIAÉ;Vereador;Masculino;62;9;0;53
LAJE DO MURIAÉ;Vereador;Feminino;23;0;0;23
LAJEADO;Vereador;Masculino;119;22;0;97
LAJEADO;Vereador;Feminino;47;2;0;45
LAJEADO DO BUGRE;Vereador;Masculino;12;9;0;3
LAJEADO DO BUGRE;Vereador;Feminino;5;0;0;5
LAJEADO GRANDE;Vereador;Masculino;17;7;0;10
LAJEADO GRANDE;Vereador;Feminino;8;2;0;6
LAJEADO NOVO;Vereador;Masculino;31;9;0;22
LAJEADO NOVO;Vereador;Feminino;15;0;0;15
LAJEDÃO;Vereador;Masculino;38;7;0;31
LAJEDÃO;Vereador;Feminino;19;2;0;17
LAJEDINHO;Vereador;Masculino;10;6;0;4
LAJEDINHO;Vereador;Feminino;5;3;0;2
LAJEDO;Vereador;Masculino;47;9;0;38
LAJEDO;Vereador;Feminino;20;4;0;16
LAJEDO DO TABOCAL;Vereador;Masculino;29;8;0;21
LAJEDO DO TABOCAL;Vereador;Feminino;14;1;0;13
LAJES;Vereador;Masculino;38;8;0;30
LAJES;Vereador;Feminino;17;1;0;16
LAJES PINTADAS;Vereador;Masculino;26;6;0;20
LAJES PINTADAS;Vereador;Feminino;14;3;0;11
LAJINHA;Vereador;Masculino;23;8;0;15
LAJINHA;Vereador;Feminino;11;1;0;10
LAMARÃO;Vereador;Masculino;14;6;0;8
LAMARÃO;Vereador;Feminino;7;3;0;4
LAMBARI;Vereador;Masculino;69;10;0;59
LAMBARI;Vereador;Feminino;36;1;0;35
LAMBARI D'OESTE;Vereador;Masculino;36;7;0;29
LAMBARI D'OESTE;Vereador;Feminino;17;2;0;15
LAMIM;Vereador;Masculino;18;8;0;10
LAMIM;Vereador;Feminino;9;1;0;8
LANDRI SALES;Vereador;Masculino;22;5;0;17
LANDRI SALES;Vereador;Feminino;12;4;0;8
LAPA;Vereador;Masculino;42;9;0;33
LAPA;Vereador;Feminino;17;0;0;17
LAPÃO;Vereador;Masculino;38;9;0;29
LAPÃO;Vereador;Feminino;18;2;0;16
LARANJA DA TERRA;Vereador;Masculino;57;9;0;48
LARANJA DA TERRA;Vereador;Feminino;28;0;0;28
LARANJAL;Vereador;Masculino;76;17;0;59
LARANJAL;Vereador;Feminino;35;1;0;34
LARANJAL DO JARI;Vereador;Masculino;83;7;0;76
LARANJAL DO JARI;Vereador;Feminino;49;2;0;47
LARANJAL PAULISTA;Vereador;Masculino;70;9;0;61
LARANJAL PAULISTA;Vereador;Feminino;35;2;0;33
LARANJEIRAS;Vereador;Masculino;53;7;0;46
LARANJEIRAS;Vereador;Feminino;27;4;0;23
LARANJEIRAS DO SUL;Vereador;Masculino;87;12;0;75
LARANJEIRAS DO SUL;Vereador;Feminino;43;1;0;42
LASSANCE;Vereador;Masculino;45;9;0;36
LASSANCE;Vereador;Feminino;23;0;0;23
LASTRO;Vereador;Masculino;13;8;0;5
LASTRO;Vereador;Feminino;8;1;0;7
LAURENTINO;Vereador;Masculino;18;7;0;11
LAURENTINO;Vereador;Feminino;10;2;0;8
LAURO DE FREITAS;Vereador;Masculino;238;13;0;225
LAURO DE FREITAS;Vereador;Feminino;107;4;0;103
LAURO MÜLLER;Vereador;Masculino;33;7;0;26
LAURO MÜLLER;Vereador;Feminino;17;2;0;15
LAVANDEIRA;Vereador;Masculino;16;7;0;9
LAVANDEIRA;Vereador;Feminino;8;2;0;6
LAVÍNIA;Vereador;Masculino;30;8;0;22
LAVÍNIA;Vereador;Feminino;16;1;0;15
LAVRAS;Vereador;Masculino;146;17;0;129
LAVRAS;Vereador;Feminino;68;0;0;68
LAVRAS DA MANGABEIRA;Vereador;Masculino;40;12;0;28
LAVRAS DA MANGABEIRA;Vereador;Feminino;22;1;0;21
LAVRAS DO SUL;Vereador;Masculino;32;9;0;23
LAVRAS DO SUL;Vereador;Feminino;11;0;0;11
LAVRINHAS;Vereador;Masculino;64;6;0;58
LAVRINHAS;Vereador;Feminino;35;3;0;32
LEANDRO FERREIRA;Vereador;Masculino;32;8;0;24
LEANDRO FERREIRA;Vereador;Feminino;16;1;0;15
LEBON RÉGIS;Vereador;Masculino;56;9;0;47
LEBON RÉGIS;Vereador;Feminino;29;0;0;29
LEME;Vereador;Masculino;164;15;0;149
LEME;Vereador;Feminino;79;2;0;77
LEME DO PRADO;Vereador;Masculino;33;9;0;24
LEME DO PRADO;Vereador;Feminino;16;0;0;16
LENÇÓIS;Vereador;Masculino;35;8;0;27
LENÇÓIS;Vereador;Feminino;19;1;0;18
LENÇÓIS PAULISTA;Vereador;Masculino;98;12;0;86
LENÇÓIS PAULISTA;Vereador;Feminino;45;0;0;45
LEOBERTO LEAL;Vereador;Masculino;19;8;0;11
LEOBERTO LEAL;Vereador;Feminino;9;1;0;8
LEOPOLDINA;Vereador;Masculino;144;14;0;130
LEOPOLDINA;Vereador;Feminino;64;1;0;63
LEOPOLDO DE BULHÕES;Vereador;Masculino;39;7;0;32
LEOPOLDO DE BULHÕES;Vereador;Feminino;19;2;0;17
LEÓPOLIS;Vereador;Masculino;26;6;0;20
LEÓPOLIS;Vereador;Feminino;13;3;0;10
LIBERATO SALZANO;Vereador;Masculino;27;9;0;18
LIBERATO SALZANO;Vereador;Feminino;12;0;0;12
LIBERDADE;Vereador;Masculino;30;8;0;22
LIBERDADE;Vereador;Feminino;14;1;0;13
LICÍNIO DE ALMEIDA;Vereador;Masculino;38;8;0;30
LICÍNIO DE ALMEIDA;Vereador;Feminino;18;1;0;17
LIDIANÓPOLIS;Vereador;Masculino;31;9;0;22
LIDIANÓPOLIS;Vereador;Feminino;16;0;0;16
LIMA CAMPOS;Vereador;Masculino;23;7;0;16
LIMA CAMPOS;Vereador;Feminino;13;2;0;11
LIMA DUARTE;Vereador;Masculino;61;11;0;50
LIMA DUARTE;Vereador;Feminino;34;0;0;34
LIMEIRA;Vereador;Masculino;229;17;0;212
LIMEIRA;Vereador;Feminino;100;4;0;96
LIMEIRA DO OESTE;Vereador;Masculino;34;9;0;25
LIMEIRA DO OESTE;Vereador;Feminino;17;0;0;17
LIMOEIRO;Vereador;Masculino;71;12;0;59
LIMOEIRO;Vereador;Feminino;30;1;0;29
LIMOEIRO DE ANADIA;Vereador;Masculino;31;10;0;21
LIMOEIRO DE ANADIA;Vereador;Feminino;14;1;0;13
LIMOEIRO DO AJURU;Vereador;Masculino;53;10;0;43
LIMOEIRO DO AJURU;Vereador;Feminino;27;1;0;26
LIMOEIRO DO NORTE;Vereador;Masculino;57;14;0;43
LIMOEIRO DO NORTE;Vereador;Feminino;25;1;0;24
LINDOESTE;Vereador;Masculino;23;7;0;16
LINDOESTE;Vereador;Feminino;12;2;0;10
LINDÓIA;Vereador;Masculino;32;7;0;25
LINDÓIA;Vereador;Feminino;16;2;0;14
LINDÓIA DO SUL;Vereador;Masculino;15;8;0;7
LINDÓIA DO SUL;Vereador;Feminino;8;1;0;7
LINDOLFO COLLOR;Vereador;Masculino;29;7;0;22
LINDOLFO COLLOR;Vereador;Feminino;14;2;0;12
LINHA NOVA;Vereador;Masculino;15;5;0;10
LINHA NOVA;Vereador;Feminino;9;4;0;5
LINHARES;Vereador;Masculino;156;13;0;143
LINHARES;Vereador;Feminino;62;0;0;62
LINS;Vereador;Masculino;122;13;0;109
LINS;Vereador;Feminino;55;2;0;53
LIVRAMENTO;Vereador;Masculino;20;7;0;13
LIVRAMENTO;Vereador;Feminino;12;2;0;10
LIVRAMENTO DE NOSSA SENHORA;Vereador;Masculino;54;13;0;41
LIVRAMENTO DE NOSSA SENHORA;Vereador;Feminino;21;0;0;21
LIZARDA;Vereador;Masculino;24;8;0;16
LIZARDA;Vereador;Feminino;12;1;0;11
LOANDA;Vereador;Masculino;44;7;0;37
LOANDA;Vereador;Feminino;24;2;0;22
LOBATO;Vereador;Masculino;24;7;0;17
LOBATO;Vereador;Feminino;12;2;0;10
LOGRADOURO;Vereador;Masculino;15;7;0;8
LOGRADOURO;Vereador;Feminino;8;2;0;6
LONDRINA;Vereador;Masculino;263;16;0;247
LONDRINA;Vereador;Feminino;117;3;0;114
LONTRA;Vereador;Masculino;33;6;0;27
LONTRA;Vereador;Feminino;19;3;0;16
LONTRAS;Vereador;Masculino;30;8;0;22
LONTRAS;Vereador;Feminino;18;1;0;17
LORENA;Vereador;Masculino;167;16;0;151
LORENA;Vereador;Feminino;74;1;0;73
LORETO;Vereador;Masculino;21;6;0;15
LORETO;Vereador;Feminino;10;3;0;7
LOURDES;Vereador;Masculino;30;7;0;23
LOURDES;Vereador;Feminino;15;2;0;13
LOUVEIRA;Vereador;Masculino;133;11;0;122
LOUVEIRA;Vereador;Feminino;66;1;0;65
LUCAS DO RIO VERDE;Vereador;Masculino;45;8;0;37
LUCAS DO RIO VERDE;Vereador;Feminino;21;1;0;20
LUCÉLIA;Vereador;Masculino;61;9;0;52
LUCÉLIA;Vereador;Feminino;30;2;0;28
LUCENA;Vereador;Masculino;48;7;0;41
LUCENA;Vereador;Feminino;23;2;0;21
LUCIANÓPOLIS;Vereador;Masculino;27;9;0;18
LUCIANÓPOLIS;Vereador;Feminino;14;0;0;14
LUCIARA;Vereador;Masculino;28;9;0;19
LUCIARA;Vereador;Feminino;14;0;0;14
LUCRÉCIA;Vereador;Masculino;11;5;0;6
LUCRÉCIA;Vereador;Feminino;8;4;0;4
LUÍS ANTÔNIO;Vereador;Masculino;69;9;0;60
LUÍS ANTÔNIO;Vereador;Feminino;34;0;0;34
LUIS CORREIA;Vereador;Masculino;42;8;0;34
LUIS CORREIA;Vereador;Feminino;20;3;0;17
LUÍS DOMINGUES;Vereador;Masculino;33;7;0;26
LUÍS DOMINGUES;Vereador;Feminino;20;2;0;18
LUÍS EDUARDO MAGALHÃES;Vereador;Masculino;110;14;0;96
LUÍS EDUARDO MAGALHÃES;Vereador;Feminino;53;1;0;52
LUÍS GOMES;Vereador;Masculino;17;6;0;11
LUÍS GOMES;Vereador;Feminino;10;3;0;7
LUISBURGO;Vereador;Masculino;37;7;0;30
LUISBURGO;Vereador;Feminino;19;2;0;17
LUISLÂNDIA;Vereador;Masculino;33;8;0;25
LUISLÂNDIA;Vereador;Feminino;16;1;0;15
LUIZ ALVES;Vereador;Masculino;33;8;0;25
LUIZ ALVES;Vereador;Feminino;16;1;0;15
LUIZIANA;Vereador;Masculino;30;8;0;22
LUIZIANA;Vereador;Feminino;14;1;0;13
LUIZIÂNIA;Vereador;Masculino;20;8;0;12
LUIZIÂNIA;Vereador;Feminino;13;1;0;12
LUMINÁRIAS;Vereador;Masculino;43;8;0;35
LUMINÁRIAS;Vereador;Feminino;20;1;0;19
LUNARDELLI;Vereador;Masculino;28;8;0;20
LUNARDELLI;Vereador;Feminino;14;1;0;13
LUPÉRCIO;Vereador;Masculino;32;7;0;25
LUPÉRCIO;Vereador;Feminino;22;2;0;20
LUPIONÓPOLIS;Vereador;Masculino;32;9;0;23
LUPIONÓPOLIS;Vereador;Feminino;2;0;0;2
LUTÉCIA;Vereador;Masculino;35;9;0;26
LUTÉCIA;Vereador;Feminino;9;0;0;9
LUZ;Vereador;Masculino;73;10;0;63
LUZ;Vereador;Feminino;36;1;0;35
LUZERNA;Vereador;Masculino;19;6;0;13
LUZERNA;Vereador;Feminino;9;3;0;6
LUZIÂNIA;Vereador;Masculino;155;13;0;142
LUZIÂNIA;Vereador;Feminino;70;6;0;64
LUZILÂNDIA;Vereador;Masculino;36;9;0;27
LUZILÂNDIA;Vereador;Feminino;17;2;0;15
LUZINÓPOLIS;Vereador;Masculino;20;8;0;12
LUZINÓPOLIS;Vereador;Feminino;9;1;0;8
MACAÉ;Vereador;Masculino;180;16;0;164
MACAÉ;Vereador;Feminino;78;1;0;77
MACAÍBA;Vereador;Masculino;63;7;0;56
MACAÍBA;Vereador;Feminino;29;6;0;23
MACAJUBA;Vereador;Masculino;24;8;0;16
MACAJUBA;Vereador;Feminino;12;1;0;11
MAÇAMBARÁ;Vereador;Masculino;23;5;0;18
MAÇAMBARÁ;Vereador;Feminino;10;4;0;6
MACAMBIRA;Vereador;Masculino;13;7;0;6
MACAMBIRA;Vereador;Feminino;7;2;0;5
MACAPÁ;Vereador;Masculino;236;18;0;218
MACAPÁ;Vereador;Feminino;98;5;0;93
MACAPARANA;Vereador;Masculino;32;9;0;23
MACAPARANA;Vereador;Feminino;14;2;0;12
MACARANI;Vereador;Masculino;39;10;0;29
MACARANI;Vereador;Feminino;20;1;0;19
MACATUBA;Vereador;Masculino;91;9;0;82
MACATUBA;Vereador;Feminino;46;2;0;44
MACAU;Vereador;Masculino;52;9;0;43
MACAU;Vereador;Feminino;26;2;0;24
MACAUBAL;Vereador;Masculino;33;7;0;26
MACAUBAL;Vereador;Feminino;19;2;0;17
MACAÚBAS;Vereador;Masculino;47;13;0;34
MACAÚBAS;Vereador;Feminino;20;0;0;20
MACEDÔNIA;Vereador;Masculino;23;7;0;16
MACEDÔNIA;Vereador;Feminino;11;2;0;9
MACEIÓ;Vereador;Masculino;324;15;0;309
MACEIÓ;Vereador;Feminino;132;6;0;126
MACHACALIS;Vereador;Masculino;34;9;0;25
MACHACALIS;Vereador;Feminino;17;0;0;17
MACHADINHO;Vereador;Masculino;21;9;0;12
MACHADINHO;Vereador;Feminino;10;0;0;10
MACHADINHO DO OESTE;Vereador;Masculino;76;12;0;64
MACHADINHO DO OESTE;Vereador;Feminino;34;1;0;33
MACHADO;Vereador;Masculino;93;10;0;83
MACHADO;Vereador;Feminino;46;3;0;43
MACHADOS;Vereador;Masculino;47;8;0;39
MACHADOS;Vereador;Feminino;15;1;0;14
MACIEIRA;Vereador;Masculino;21;8;0;13
MACIEIRA;Vereador;Feminino;11;1;0;10
MACUCO;Vereador;Masculino;60;8;0;52
MACUCO;Vereador;Feminino;32;1;0;31
MACURURÉ;Vereador;Masculino;21;9;0;12
MACURURÉ;Vereador;Feminino;9;0;0;9
MADALENA;Vereador;Masculino;37;9;0;28
MADALENA;Vereador;Feminino;16;2;0;14
MADEIRO;Vereador;Masculino;16;8;0;8
MADEIRO;Vereador;Feminino;8;1;0;7
MADRE DE DEUS;Vereador;Masculino;58;8;0;50
MADRE DE DEUS;Vereador;Feminino;28;3;0;25
MADRE DE DEUS DE MINAS;Vereador;Masculino;32;6;0;26
MADRE DE DEUS DE MINAS;Vereador;Feminino;14;3;0;11
MÃE D'ÁGUA;Vereador;Masculino;20;8;0;12
MÃE D'ÁGUA;Vereador;Feminino;9;1;0;8
MÃE DO RIO;Vereador;Masculino;63;8;0;55
MÃE DO RIO;Vereador;Feminino;33;3;0;30
MAETINGA;Vereador;Masculino;24;8;0;16
MAETINGA;Vereador;Feminino;11;1;0;10
MAFRA;Vereador;Masculino;66;8;0;58
MAFRA;Vereador;Feminino;32;2;0;30
MAGALHÃES BARATA;Vereador;Masculino;45;7;0;38
MAGALHÃES BARATA;Vereador;Feminino;10;2;0;8
MAGALHÃES DE ALMEIDA;Vereador;Masculino;29;8;0;21
MAGALHÃES DE ALMEIDA;Vereador;Feminino;13;1;0;12
MAGDA;Vereador;Masculino;21;9;0;12
MAGDA;Vereador;Feminino;10;0;0;10
MAGÉ;Vereador;Masculino;211;16;0;195
MAGÉ;Vereador;Feminino;87;1;0;86
MAIQUINIQUE;Vereador;Masculino;29;6;0;23
MAIQUINIQUE;Vereador;Feminino;17;3;0;14
MAIRI;Vereador;Masculino;35;10;0;25
MAIRI;Vereador;Feminino;15;1;0;14
MAIRINQUE;Vereador;Masculino;146;11;0;135
MAIRINQUE;Vereador;Feminino;69;2;0;67
MAIRIPORÃ;Vereador;Masculino;160;12;0;148
MAIRIPORÃ;Vereador;Feminino;73;1;0;72
MAIRIPOTABA;Vereador;Masculino;21;9;0;12
MAIRIPOTABA;Vereador;Feminino;10;0;0;10
MAJOR GERCINO;Vereador;Masculino;18;8;0;10
MAJOR GERCINO;Vereador;Feminino;9;1;0;8
MAJOR ISIDORO;Vereador;Masculino;32;10;0;22
MAJOR ISIDORO;Vereador;Feminino;15;1;0;14
MAJOR SALES;Vereador;Masculino;11;8;0;3
MAJOR SALES;Vereador;Feminino;7;1;0;6
MAJOR VIEIRA;Vereador;Masculino;34;7;0;27
MAJOR VIEIRA;Vereador;Feminino;16;2;0;14
MALACACHETA;Vereador;Masculino;73;9;0;64
MALACACHETA;Vereador;Feminino;37;2;0;35
MALHADA;Vereador;Masculino;36;9;0;27
MALHADA;Vereador;Feminino;17;2;0;15
MALHADA DE PEDRAS;Vereador;Masculino;20;7;0;13
MALHADA DE PEDRAS;Vereador;Feminino;11;2;0;9
MALHADA DOS BOIS;Vereador;Masculino;21;6;0;15
MALHADA DOS BOIS;Vereador;Feminino;10;3;0;7
MALHADOR;Vereador;Masculino;25;7;0;18
MALHADOR;Vereador;Feminino;11;2;0;9
MALLET;Vereador;Masculino;67;7;0;60
MALLET;Vereador;Feminino;32;2;0;30
MALTA;Vereador;Masculino;15;5;0;10
MALTA;Vereador;Feminino;11;4;0;7
MAMANGUAPE;Vereador;Masculino;74;10;0;64
MAMANGUAPE;Vereador;Feminino;33;3;0;30
MAMBAÍ;Vereador;Masculino;30;9;0;21
MAMBAÍ;Vereador;Feminino;13;0;0;13
MAMBORÊ;Vereador;Masculino;58;8;0;50
MAMBORÊ;Vereador;Feminino;29;1;0;28
MAMONAS;Vereador;Masculino;19;9;0;10
MAMONAS;Vereador;Feminino;9;0;0;9
MAMPITUBA;Vereador;Masculino;20;8;0;12
MAMPITUBA;Vereador;Feminino;10;1;0;9
MANACAPURU;Vereador;Masculino;117;14;0;103
MANACAPURU;Vereador;Feminino;49;1;0;48
MANAÍRA;Vereador;Masculino;21;8;0;13
MANAÍRA;Vereador;Feminino;11;1;0;10
MANAQUIRI;Vereador;Masculino;52;10;0;42
MANAQUIRI;Vereador;Feminino;24;1;0;23
MANARI;Vereador;Masculino;29;10;0;19
MANARI;Vereador;Feminino;14;1;0;13
MANAUS;Vereador;Masculino;573;36;0;537
MANAUS;Vereador;Feminino;216;5;0;211
MÂNCIO LIMA;Vereador;Masculino;53;6;0;47
MÂNCIO LIMA;Vereador;Feminino;28;3;0;25
MANDAGUAÇU;Vereador;Masculino;73;8;0;65
MANDAGUAÇU;Vereador;Feminino;36;1;0;35
MANDAGUARI;Vereador;Masculino;63;8;0;55
MANDAGUARI;Vereador;Feminino;31;1;0;30
MANDIRITUBA;Vereador;Masculino;58;8;0;50
MANDIRITUBA;Vereador;Feminino;25;1;0;24
MANDURI;Vereador;Masculino;42;8;0;34
MANDURI;Vereador;Feminino;21;1;0;20
MANFRINÓPOLIS;Vereador;Masculino;26;8;0;18
MANFRINÓPOLIS;Vereador;Feminino;14;1;0;13
MANGA;Vereador;Masculino;56;9;0;47
MANGA;Vereador;Feminino;26;0;0;26
MANGARATIBA;Vereador;Masculino;89;10;0;79
MANGARATIBA;Vereador;Feminino;36;1;0;35
MANGUEIRINHA;Vereador;Masculino;56;10;0;46
MANGUEIRINHA;Vereador;Feminino;28;1;0;27
MANHUAÇU;Vereador;Masculino;136;14;0;122
MANHUAÇU;Vereador;Feminino;56;1;0;55
MANHUMIRIM;Vereador;Masculino;65;10;0;55
MANHUMIRIM;Vereador;Feminino;31;1;0;30
MANICORÉ;Vereador;Masculino;65;13;0;52
MANICORÉ;Vereador;Feminino;33;0;0;33
MANOEL EMÍDIO;Vereador;Masculino;17;7;0;10
MANOEL EMÍDIO;Vereador;Feminino;8;2;0;6
MANOEL RIBAS;Vereador;Masculino;47;9;0;38
MANOEL RIBAS;Vereador;Feminino;25;0;0;25
MANOEL URBANO;Vereador;Masculino;43;8;0;35
MANOEL URBANO;Vereador;Feminino;20;1;0;19
MANOEL VIANA;Vereador;Masculino;32;6;0;26
MANOEL VIANA;Vereador;Feminino;16;3;0;13
MANOEL VITORINO;Vereador;Masculino;35;7;0;28
MANOEL VITORINO;Vereador;Feminino;19;2;0;17
MANSIDÃO;Vereador;Masculino;25;8;0;17
MANSIDÃO;Vereador;Feminino;12;1;0;11
MANTENA;Vereador;Masculino;63;10;0;53
MANTENA;Vereador;Feminino;30;1;0;29
MANTENÓPOLIS;Vereador;Masculino;45;8;0;37
MANTENÓPOLIS;Vereador;Feminino;24;1;0;23
MAQUINÉ;Vereador;Masculino;25;7;0;18
MAQUINÉ;Vereador;Feminino;13;2;0;11
MAR DE ESPANHA;Vereador;Masculino;36;6;0;30
MAR DE ESPANHA;Vereador;Feminino;18;3;0;15
MAR VERMELHO;Vereador;Masculino;24;8;0;16
MAR VERMELHO;Vereador;Feminino;12;1;0;11
MARA ROSA;Vereador;Masculino;41;8;0;33
MARA ROSA;Vereador;Feminino;22;1;0;21
MARAÃ;Vereador;Masculino;64;10;0;54
MARAÃ;Vereador;Feminino;29;1;0;28
MARABÁ;Vereador;Masculino;250;17;0;233
MARABÁ;Vereador;Feminino;120;4;0;116
MARABÁ PAULISTA;Vereador;Masculino;21;7;0;14
MARABÁ PAULISTA;Vereador;Feminino;10;2;0;8
MARACAÇUMÉ;Vereador;Masculino;64;7;0;57
MARACAÇUMÉ;Vereador;Feminino;26;4;0;22
MARACAÍ;Vereador;Masculino;65;9;0;56
MARACAÍ;Vereador;Feminino;34;0;0;34
MARACAJÁ;Vereador;Masculino;19;7;0;12
MARACAJÁ;Vereador;Feminino;9;2;0;7
MARACAJU;Vereador;Masculino;80;13;0;67
MARACAJU;Vereador;Feminino;34;0;0;34
MARACANÃ;Vereador;Masculino;64;9;0;55
MARACANÃ;Vereador;Feminino;31;2;0;29
MARACANAÚ;Vereador;Masculino;262;18;0;244
MARACANAÚ;Vereador;Feminino;120;3;0;117
MARACÁS;Vereador;Masculino;50;9;0;41
MARACÁS;Vereador;Feminino;17;2;0;15
MARAGOGI;Vereador;Masculino;51;8;0;43
MARAGOGI;Vereador;Feminino;20;1;0;19
MARAGOGIPE;Vereador;Masculino;95;8;0;87
MARAGOGIPE;Vereador;Feminino;47;1;0;46
MARAIAL;Vereador;Masculino;61;8;0;53
MARAIAL;Vereador;Feminino;32;1;0;31
MARAJÁ DO SENA;Vereador;Masculino;40;9;0;31
MARAJÁ DO SENA;Vereador;Feminino;21;0;0;21
MARANGUAPE;Vereador;Masculino;103;17;0;86
MARANGUAPE;Vereador;Feminino;48;0;0;48
MARANHÃOZINHO;Vereador;Masculino;31;7;0;24
MARANHÃOZINHO;Vereador;Feminino;13;2;0;11
MARAPANIM;Vereador;Masculino;77;8;0;69
MARAPANIM;Vereador;Feminino;35;3;0;32
MARAPOAMA;Vereador;Masculino;23;9;0;14
MARAPOAMA;Vereador;Feminino;12;0;0;12
MARATÁ;Vereador;Masculino;24;8;0;16
MARATÁ;Vereador;Feminino;12;1;0;11
MARATAÍZES;Vereador;Masculino;107;13;0;94
MARATAÍZES;Vereador;Feminino;49;0;0;49
MARAU;Vereador;Masculino;52;8;0;44
MARAU;Vereador;Feminino;27;1;0;26
MARAÚ;Vereador;Masculino;50;11;0;39
MARAÚ;Vereador;Feminino;28;0;0;28
MARAVILHA;Vereador;Masculino;56;16;0;40
MARAVILHA;Vereador;Feminino;25;4;0;21
MARAVILHAS;Vereador;Masculino;40;8;0;32
MARAVILHAS;Vereador;Feminino;20;1;0;19
MARCAÇÃO;Vereador;Masculino;33;7;0;26
MARCAÇÃO;Vereador;Feminino;15;2;0;13
MARCELÂNDIA;Vereador;Masculino;49;8;0;41
MARCELÂNDIA;Vereador;Feminino;28;1;0;27
MARCELINO RAMOS;Vereador;Masculino;18;9;0;9
MARCELINO RAMOS;Vereador;Feminino;9;0;0;9
MARCELINO VIEIRA;Vereador;Masculino;16;8;0;8
MARCELINO VIEIRA;Vereador;Feminino;8;1;0;7
MARCIONÍLIO SOUZA;Vereador;Masculino;22;7;0;15
MARCIONÍLIO SOUZA;Vereador;Feminino;10;2;0;8
MARCO;Vereador;Masculino;40;7;0;33
MARCO;Vereador;Feminino;13;4;0;9
MARCOLÂNDIA;Vereador;Masculino;19;7;0;12
MARCOLÂNDIA;Vereador;Feminino;8;2;0;6
MARCOS PARENTE;Vereador;Masculino;22;7;0;15
MARCOS PARENTE;Vereador;Feminino;12;2;0;10
MARECHAL CÂNDIDO RONDON;Vereador;Masculino;56;8;0;48
MARECHAL CÂNDIDO RONDON;Vereador;Feminino;28;1;0;27
MARECHAL DEODORO;Vereador;Masculino;103;12;0;91
MARECHAL DEODORO;Vereador;Feminino;45;1;0;44
MARECHAL FLORIANO;Vereador;Masculino;60;9;0;51
MARECHAL FLORIANO;Vereador;Feminino;30;0;0;30
MARECHAL THAUMATURGO;Vereador;Masculino;52;8;0;44
MARECHAL THAUMATURGO;Vereador;Feminino;25;1;0;24
MAREMA;Vereador;Masculino;19;9;0;10
MAREMA;Vereador;Feminino;8;0;0;8
MARI;Vereador;Masculino;55;9;0;46
MARI;Vereador;Feminino;29;2;0;27
MARIA DA FÉ;Vereador;Masculino;75;7;0;68
MARIA DA FÉ;Vereador;Feminino;39;2;0;37
MARIA HELENA;Vereador;Masculino;45;9;0;36
MARIA HELENA;Vereador;Feminino;21;0;0;21
MARIALVA;Vereador;Masculino;81;7;0;74
MARIALVA;Vereador;Feminino;39;2;0;37
MARIANA;Vereador;Masculino;106;14;0;92
MARIANA;Vereador;Feminino;51;1;0;50
MARIANA PIMENTEL;Vereador;Masculino;29;8;0;21
MARIANA PIMENTEL;Vereador;Feminino;14;1;0;13
MARIANO MORO;Vereador;Masculino;18;9;0;9
MARIANO MORO;Vereador;Feminino;9;0;0;9
MARIANÓPOLIS DO TOCANTINS;Vereador;Masculino;26;9;0;17
MARIANÓPOLIS DO TOCANTINS;Vereador;Feminino;13;0;0;13
MARIÁPOLIS;Vereador;Masculino;24;8;0;16
MARIÁPOLIS;Vereador;Feminino;12;1;0;11
MARIBONDO;Vereador;Masculino;31;8;0;23
MARIBONDO;Vereador;Feminino;13;1;0;12
MARICÁ;Vereador;Masculino;157;11;0;146
MARICÁ;Vereador;Feminino;74;0;0;74
MARILAC;Vereador;Masculino;34;8;0;26
MARILAC;Vereador;Feminino;17;1;0;16
MARILÂNDIA;Vereador;Masculino;40;9;0;31
MARILÂNDIA;Vereador;Feminino;18;0;0;18
MARILÂNDIA DO SUL;Vereador;Masculino;33;9;0;24
MARILÂNDIA DO SUL;Vereador;Feminino;19;0;0;19
MARILENA;Vereador;Masculino;30;8;0;22
MARILENA;Vereador;Feminino;15;1;0;14
MARÍLIA;Vereador;Masculino;190;12;0;178
MARÍLIA;Vereador;Feminino;81;1;0;80
MARILUZ;Vereador;Masculino;36;8;0;28
MARILUZ;Vereador;Feminino;8;1;0;7
MARINGÁ;Vereador;Masculino;233;14;0;219
MARINGÁ;Vereador;Feminino;103;1;0;102
MARINÓPOLIS;Vereador;Masculino;21;8;0;13
MARINÓPOLIS;Vereador;Feminino;11;1;0;10
MÁRIO CAMPOS;Vereador;Masculino;78;8;0;70
MÁRIO CAMPOS;Vereador;Feminino;38;1;0;37
MARIÓPOLIS;Vereador;Masculino;19;8;0;11
MARIÓPOLIS;Vereador;Feminino;10;1;0;9
MARIPÁ;Vereador;Masculino;20;7;0;13
MARIPÁ;Vereador;Feminino;13;2;0;11
MARIPÁ DE MINAS;Vereador;Masculino;20;8;0;12
MARIPÁ DE MINAS;Vereador;Feminino;9;1;0;8
MARITUBA;Vereador;Masculino;134;13;0;121
MARITUBA;Vereador;Feminino;54;0;0;54
MARIZÓPOLIS;Vereador;Masculino;20;9;0;11
MARIZÓPOLIS;Vereador;Feminino;9;0;0;9
MARLIÉRIA;Vereador;Masculino;38;6;0;32
MARLIÉRIA;Vereador;Feminino;22;3;0;19
MARMELEIRO;Vereador;Masculino;21;8;0;13
MARMELEIRO;Vereador;Feminino;11;1;0;10
MARMELÓPOLIS;Vereador;Masculino;19;9;0;10
MARMELÓPOLIS;Vereador;Feminino;9;0;0;9
MARQUES DE SOUZA;Vereador;Masculino;23;6;0;17
MARQUES DE SOUZA;Vereador;Feminino;13;3;0;10
MARQUINHO;Vereador;Masculino;28;8;0;20
MARQUINHO;Vereador;Feminino;14;1;0;13
MARTINHO CAMPOS;Vereador;Masculino;57;8;0;49
MARTINHO CAMPOS;Vereador;Feminino;29;1;0;28
MARTINÓPOLE;Vereador;Masculino;26;6;0;20
MARTINÓPOLE;Vereador;Feminino;14;3;0;11
MARTINÓPOLIS;Vereador;Masculino;85;9;0;76
MARTINÓPOLIS;Vereador;Feminino;39;2;0;37
MARTINS;Vereador;Masculino;19;8;0;11
MARTINS;Vereador;Feminino;9;1;0;8
MARTINS SOARES;Vereador;Masculino;42;9;0;33
MARTINS SOARES;Vereador;Feminino;23;0;0;23
MARUIM;Vereador;Masculino;35;7;0;28
MARUIM;Vereador;Feminino;18;2;0;16
MARUMBI;Vereador;Masculino;31;8;0;23
MARUMBI;Vereador;Feminino;16;1;0;15
MARZAGÃO;Vereador;Masculino;21;9;0;12
MARZAGÃO;Vereador;Feminino;11;0;0;11
MASCOTE;Vereador;Masculino;44;7;0;37
MASCOTE;Vereador;Feminino;19;2;0;17
MASSAPÊ;Vereador;Masculino;31;12;0;19
MASSAPÊ;Vereador;Feminino;14;1;0;13
MASSAPÊ DO PIAUÍ;Vereador;Masculino;20;9;0;11
MASSAPÊ DO PIAUÍ;Vereador;Feminino;9;0;0;9
MASSARANDUBA;Vereador;Masculino;71;15;0;56
MASSARANDUBA;Vereador;Feminino;23;3;0;20
MATA;Vereador;Masculino;18;8;0;10
MATA;Vereador;Feminino;9;1;0;8
MATA DE SÃO JOÃO;Vereador;Masculino;72;11;0;61
MATA DE SÃO JOÃO;Vereador;Feminino;30;2;0;28
MATA GRANDE;Vereador;Masculino;30;7;0;23
MATA GRANDE;Vereador;Feminino;14;4;0;10
MATA ROMA;Vereador;Masculino;17;8;0;9
MATA ROMA;Vereador;Feminino;10;3;0;7
MATA VERDE;Vereador;Masculino;35;6;0;29
MATA VERDE;Vereador;Feminino;15;3;0;12
MATÃO;Vereador;Masculino;132;14;0;118
MATÃO;Vereador;Feminino;63;1;0;62
MATARACA;Vereador;Masculino;36;8;0;28
MATARACA;Vereador;Feminino;19;1;0;18
MATEIROS;Vereador;Masculino;26;9;0;17
MATEIROS;Vereador;Feminino;11;0;0;11
MATELÂNDIA;Vereador;Masculino;29;8;0;21
MATELÂNDIA;Vereador;Feminino;13;3;0;10
MATERLÂNDIA;Vereador;Masculino;32;9;0;23
MATERLÂNDIA;Vereador;Feminino;15;0;0;15
MATEUS LEME;Vereador;Masculino;118;9;0;109
MATEUS LEME;Vereador;Feminino;61;0;0;61
MATHIAS LOBATO;Vereador;Masculino;48;8;0;40
MATHIAS LOBATO;Vereador;Feminino;23;1;0;22
MATIAS BARBOSA;Vereador;Masculino;86;8;0;78
MATIAS BARBOSA;Vereador;Feminino;43;1;0;42
MATIAS CARDOSO;Vereador;Masculino;39;9;0;30
MATIAS CARDOSO;Vereador;Feminino;20;0;0;20
MATIAS OLÍMPIO;Vereador;Masculino;25;6;0;19
MATIAS OLÍMPIO;Vereador;Feminino;14;3;0;11
MATINA;Vereador;Masculino;18;8;0;10
MATINA;Vereador;Feminino;10;1;0;9
MATINHA;Vereador;Masculino;45;10;0;35
MATINHA;Vereador;Feminino;20;1;0;19
MATINHAS;Vereador;Masculino;18;5;0;13
MATINHAS;Vereador;Feminino;12;4;0;8
MATINHOS;Vereador;Masculino;87;11;0;76
MATINHOS;Vereador;Feminino;39;0;0;39
MATIPÓ;Vereador;Masculino;55;11;0;44
MATIPÓ;Vereador;Feminino;26;0;0;26
MATO CASTELHANO;Vereador;Masculino;21;8;0;13
MATO CASTELHANO;Vereador;Feminino;11;1;0;10
MATO GROSSO;Vereador;Masculino;13;7;0;6
MATO GROSSO;Vereador;Feminino;8;2;0;6
MATO LEITÃO;Vereador;Masculino;37;8;0;29
MATO LEITÃO;Vereador;Feminino;19;1;0;18
MATO QUEIMADO;Vereador;Masculino;8;7;0;1
MATO QUEIMADO;Vereador;Feminino;3;2;0;1
MATO RICO;Vereador;Masculino;31;8;0;23
MATO RICO;Vereador;Feminino;16;1;0;15
MATO VERDE;Vereador;Masculino;32;9;0;23
MATO VERDE;Vereador;Feminino;16;0;0;16
MATÕES;Vereador;Masculino;54;9;0;45
MATÕES;Vereador;Feminino;24;4;0;20
MATÕES DO NORTE;Vereador;Masculino;35;7;0;28
MATÕES DO NORTE;Vereador;Feminino;18;2;0;16
MATOS COSTA;Vereador;Masculino;20;8;0;12
MATOS COSTA;Vereador;Feminino;9;1;0;8
MATOZINHOS;Vereador;Masculino;125;11;0;114
MATOZINHOS;Vereador;Feminino;60;2;0;58
MATRINCHÃ;Vereador;Masculino;29;7;0;22
MATRINCHÃ;Vereador;Feminino;13;2;0;11
MATRIZ DE CAMARAGIBE;Vereador;Masculino;59;10;0;49
MATRIZ DE CAMARAGIBE;Vereador;Feminino;27;1;0;26
MATUPÁ;Vereador;Masculino;25;8;0;17
MATUPÁ;Vereador;Feminino;10;1;0;9
MATURÉIA;Vereador;Masculino;21;9;0;12
MATURÉIA;Vereador;Feminino;7;0;0;7
MATUTINA;Vereador;Masculino;18;8;0;10
MATUTINA;Vereador;Feminino;10;1;0;9
MAUÁ;Vereador;Masculino;271;22;0;249
MAUÁ;Vereador;Feminino;124;1;0;123
MAUÁ DA SERRA;Vereador;Masculino;48;9;0;39
MAUÁ DA SERRA;Vereador;Feminino;22;0;0;22
MAUÉS;Vereador;Masculino;99;13;0;86
MAUÉS;Vereador;Feminino;46;2;0;44
MAURILÂNDIA;Vereador;Masculino;50;8;0;42
MAURILÂNDIA;Vereador;Feminino;26;1;0;25
MAURILÂNDIA DO TOCANTINS;Vereador;Masculino;22;6;0;16
MAURILÂNDIA DO TOCANTINS;Vereador;Feminino;12;3;0;9
MAURITI;Vereador;Masculino;37;10;0;27
MAURITI;Vereador;Feminino;18;3;0;15
MAXARANGUAPE;Vereador;Masculino;41;7;0;34
MAXARANGUAPE;Vereador;Feminino;18;2;0;16
MAXIMILIANO DE ALMEIDA;Vereador;Masculino;17;5;0;12
MAXIMILIANO DE ALMEIDA;Vereador;Feminino;8;4;0;4
MAZAGÃO;Vereador;Masculino;55;9;0;46
MAZAGÃO;Vereador;Feminino;29;2;0;27
MEDEIROS;Vereador;Masculino;26;8;0;18
MEDEIROS;Vereador;Feminino;13;1;0;12
MEDEIROS NETO;Vereador;Masculino;28;9;0;19
MEDEIROS NETO;Vereador;Feminino;13;2;0;11
MEDIANEIRA;Vereador;Masculino;57;7;0;50
MEDIANEIRA;Vereador;Feminino;30;2;0;28
MEDICILÂNDIA;Vereador;Masculino;57;10;0;47
MEDICILÂNDIA;Vereador;Feminino;28;1;0;27
MEDINA;Vereador;Masculino;47;9;0;38
MEDINA;Vereador;Feminino;27;0;0;27
MELEIRO;Vereador;Masculino;16;7;0;9
MELEIRO;Vereador;Feminino;7;2;0;5
MELGAÇO;Vereador;Masculino;46;11;0;35
MELGAÇO;Vereador;Feminino;17;0;0;17
MENDES;Vereador;Masculino;108;9;0;99
MENDES;Vereador;Feminino;55;0;0;55
MENDES PIMENTEL;Vereador;Masculino;18;8;0;10
MENDES PIMENTEL;Vereador;Feminino;9;1;0;8
MENDONÇA;Vereador;Masculino;42;8;0;34
MENDONÇA;Vereador;Feminino;20;1;0;19
MERCEDES;Vereador;Masculino;17;7;0;10
MERCEDES;Vereador;Feminino;10;2;0;8
MERCÊS;Vereador;Masculino;47;8;0;39
MERCÊS;Vereador;Feminino;28;1;0;27
MERIDIANO;Vereador;Masculino;29;9;0;20
MERIDIANO;Vereador;Feminino;13;0;0;13
MERUOCA;Vereador;Masculino;24;6;0;18
MERUOCA;Vereador;Feminino;12;3;0;9
MESÓPOLIS;Vereador;Masculino;15;7;0;8
MESÓPOLIS;Vereador;Feminino;8;2;0;6
MESQUITA;Vereador;Masculino;234;19;0;215
MESQUITA;Vereador;Feminino;118;2;0;116
MESSIAS;Vereador;Masculino;61;8;0;53
MESSIAS;Vereador;Feminino;31;1;0;30
MESSIAS TARGINO;Vereador;Masculino;19;8;0;11
MESSIAS TARGINO;Vereador;Feminino;9;1;0;8
MIGUEL ALVES;Vereador;Masculino;60;12;0;48
MIGUEL ALVES;Vereador;Feminino;28;1;0;27
MIGUEL CALMON;Vereador;Masculino;45;9;0;36
MIGUEL CALMON;Vereador;Feminino;22;2;0;20
MIGUEL LEÃO;Vereador;Masculino;21;6;0;15
MIGUEL LEÃO;Vereador;Feminino;12;3;0;9
MIGUEL PEREIRA;Vereador;Masculino;119;10;0;109
MIGUEL PEREIRA;Vereador;Feminino;63;1;0;62
MIGUELÓPOLIS;Vereador;Masculino;64;11;0;53
MIGUELÓPOLIS;Vereador;Feminino;33;0;0;33
MILAGRES;Vereador;Masculino;56;18;0;38
MILAGRES;Vereador;Feminino;27;2;0;25
MILAGRES DO MARANHÃO;Vereador;Masculino;27;9;0;18
MILAGRES DO MARANHÃO;Vereador;Feminino;11;0;0;11
MILHÃ;Vereador;Masculino;25;7;0;18
MILHÃ;Vereador;Feminino;17;2;0;15
MILTON BRANDÃO;Vereador;Masculino;14;8;0;6
MILTON BRANDÃO;Vereador;Feminino;5;1;0;4
MIMOSO DE GOIÁS;Vereador;Masculino;37;9;0;28
MIMOSO DE GOIÁS;Vereador;Feminino;20;0;0;20
MIMOSO DO SUL;Vereador;Masculino;87;10;0;77
MIMOSO DO SUL;Vereador;Feminino;41;1;0;40
MINAÇU;Vereador;Masculino;57;10;0;47
MINAÇU;Vereador;Feminino;14;3;0;11
MINADOR DO NEGRÃO;Vereador;Masculino;11;8;0;3
MINADOR DO NEGRÃO;Vereador;Feminino;6;1;0;5
MINAS DO LEÃO;Vereador;Masculino;23;7;0;16
MINAS DO LEÃO;Vereador;Feminino;12;2;0;10
MINAS NOVAS;Vereador;Masculino;58;12;0;46
MINAS NOVAS;Vereador;Feminino;28;1;0;27
MINDURI;Vereador;Masculino;41;7;0;34
MINDURI;Vereador;Feminino;19;2;0;17
MINEIROS;Vereador;Masculino;66;12;0;54
MINEIROS;Vereador;Feminino;33;3;0;30
MINEIROS DO TIETÊ;Vereador;Masculino;43;7;0;36
MINEIROS DO TIETÊ;Vereador;Feminino;24;2;0;22
MINISTRO ANDREAZZA;Vereador;Masculino;26;8;0;18
MINISTRO ANDREAZZA;Vereador;Feminino;13;1;0;12
MIRA ESTRELA;Vereador;Masculino;29;8;0;21
MIRA ESTRELA;Vereador;Feminino;13;1;0;12
MIRABELA;Vereador;Masculino;55;8;0;47
MIRABELA;Vereador;Feminino;30;1;0;29
MIRACATU;Vereador;Masculino;71;10;0;61
MIRACATU;Vereador;Feminino;33;1;0;32
MIRACEMA;Vereador;Masculino;99;10;0;89
MIRACEMA;Vereador;Feminino;44;1;0;43
MIRACEMA DO TOCANTINS;Vereador;Masculino;75;9;0;66
MIRACEMA DO TOCANTINS;Vereador;Feminino;15;2;0;13
MIRADOR;Vereador;Masculino;55;19;0;36
MIRADOR;Vereador;Feminino;22;1;0;21
MIRADOURO;Vereador;Masculino;24;7;0;17
MIRADOURO;Vereador;Feminino;12;2;0;10
MIRAGUAÍ;Vereador;Masculino;17;8;0;9
MIRAGUAÍ;Vereador;Feminino;10;1;0;9
MIRAÍ;Vereador;Masculino;49;7;0;42
MIRAÍ;Vereador;Feminino;26;2;0;24
MIRAÍMA;Vereador;Masculino;19;8;0;11
MIRAÍMA;Vereador;Feminino;11;1;0;10
MIRANDA;Vereador;Masculino;69;9;0;60
MIRANDA;Vereador;Feminino;37;2;0;35
MIRANDA DO NORTE;Vereador;Masculino;40;7;0;33
MIRANDA DO NORTE;Vereador;Feminino;25;4;0;21
MIRANDIBA;Vereador;Masculino;47;6;0;41
MIRANDIBA;Vereador;Feminino;29;3;0;26
MIRANDÓPOLIS;Vereador;Masculino;43;8;0;35
MIRANDÓPOLIS;Vereador;Feminino;21;1;0;20
MIRANGABA;Vereador;Masculino;39;10;0;29
MIRANGABA;Vereador;Feminino;20;1;0;19
MIRANORTE;Vereador;Masculino;42;8;0;34
MIRANORTE;Vereador;Feminino;19;1;0;18
MIRANTE;Vereador;Masculino;29;8;0;21
MIRANTE;Vereador;Feminino;15;1;0;14
MIRANTE DA SERRA;Vereador;Masculino;51;9;0;42
MIRANTE DA SERRA;Vereador;Feminino;25;0;0;25
MIRANTE DO PARANAPANEMA;Vereador;Masculino;53;8;0;45
MIRANTE DO PARANAPANEMA;Vereador;Feminino;27;1;0;26
MIRASELVA;Vereador;Masculino;20;8;0;12
MIRASELVA;Vereador;Feminino;3;1;0;2
MIRASSOL;Vereador;Masculino;84;9;0;75
MIRASSOL;Vereador;Feminino;37;1;0;36
MIRASSOL D'OESTE;Vereador;Masculino;57;7;0;50
MIRASSOL D'OESTE;Vereador;Feminino;28;2;0;26
MIRASSOLÂNDIA;Vereador;Masculino;29;6;0;23
MIRASSOLÂNDIA;Vereador;Feminino;13;3;0;10
MIRAVÂNIA;Vereador;Masculino;20;7;0;13
MIRAVÂNIA;Vereador;Feminino;9;2;0;7
MIRIM DOCE;Vereador;Masculino;22;8;0;14
MIRIM DOCE;Vereador;Feminino;11;1;0;10
MIRINZAL;Vereador;Masculino;48;8;0;40
MIRINZAL;Vereador;Feminino;24;1;0;23
MISSAL;Vereador;Masculino;19;9;0;10
MISSAL;Vereador;Feminino;9;0;0;9
MISSÃO VELHA;Vereador;Masculino;28;11;0;17
MISSÃO VELHA;Vereador;Feminino;12;2;0;10
MOCAJUBA;Vereador;Masculino;48;10;0;38
MOCAJUBA;Vereador;Feminino;21;1;0;20
MOCOCA;Vereador;Masculino;126;13;0;113
MOCOCA;Vereador;Feminino;59;2;0;57
MODELO;Vereador;Masculino;16;7;0;9
MODELO;Vereador;Feminino;7;2;0;5
MOEDA;Vereador;Masculino;33;9;0;24
MOEDA;Vereador;Feminino;17;0;0;17
MOEMA;Vereador;Masculino;41;8;0;33
MOEMA;Vereador;Feminino;19;1;0;18
MOGEIRO;Vereador;Masculino;38;8;0;30
MOGEIRO;Vereador;Feminino;23;1;0;22
MOGI DAS CRUZES;Vereador;Masculino;288;20;0;268
MOGI DAS CRUZES;Vereador;Feminino;131;3;0;128
MOGI GUAÇU;Vereador;Masculino;119;11;0;108
MOGI GUAÇU;Vereador;Feminino;55;0;0;55
MOGI MIRIM;Vereador;Masculino;135;14;0;121
MOGI MIRIM;Vereador;Feminino;61;3;0;58
MOIPORÁ;Vereador;Masculino;28;8;0;20
MOIPORÁ;Vereador;Feminino;9;1;0;8
MOITA BONITA;Vereador;Masculino;19;7;0;12
MOITA BONITA;Vereador;Feminino;10;2;0;8
MOJU;Vereador;Masculino;113;10;0;103
MOJU;Vereador;Feminino;52;3;0;49
MOJUÍ DOS CAMPOS;Vereador;Masculino;75;8;0;67
MOJUÍ DOS CAMPOS;Vereador;Feminino;39;1;0;38
MOMBAÇA;Vereador;Masculino;35;12;0;23
MOMBAÇA;Vereador;Feminino;22;1;0;21
MOMBUCA;Vereador;Masculino;47;8;0;39
MOMBUCA;Vereador;Feminino;25;1;0;24
MONÇÃO;Vereador;Masculino;51;8;0;43
MONÇÃO;Vereador;Feminino;26;3;0;23
MONÇÕES;Vereador;Masculino;12;7;0;5
MONÇÕES;Vereador;Feminino;6;2;0;4
MONDAÍ;Vereador;Masculino;24;6;0;18
MONDAÍ;Vereador;Feminino;12;3;0;9
MONGAGUÁ;Vereador;Masculino;111;13;0;98
MONGAGUÁ;Vereador;Feminino;51;0;0;51
MONJOLOS;Vereador;Masculino;31;7;0;24
MONJOLOS;Vereador;Feminino;14;2;0;12
MONSENHOR GIL;Vereador;Masculino;33;8;0;25
MONSENHOR GIL;Vereador;Feminino;16;1;0;15
MONSENHOR HIPÓLITO;Vereador;Masculino;18;7;0;11
MONSENHOR HIPÓLITO;Vereador;Feminino;7;2;0;5
MONSENHOR PAULO;Vereador;Masculino;23;7;0;16
MONSENHOR PAULO;Vereador;Feminino;11;2;0;9
MONSENHOR TABOSA;Vereador;Masculino;26;10;0;16
MONSENHOR TABOSA;Vereador;Feminino;14;1;0;13
MONTADAS;Vereador;Masculino;20;8;0;12
MONTADAS;Vereador;Feminino;11;1;0;10
MONTALVÂNIA;Vereador;Masculino;30;11;0;19
MONTALVÂNIA;Vereador;Feminino;14;0;0;14
MONTANHA;Vereador;Masculino;49;9;0;40
MONTANHA;Vereador;Feminino;14;0;0;14
MONTANHAS;Vereador;Masculino;23;6;0;17
MONTANHAS;Vereador;Feminino;16;3;0;13
MONTAURI;Vereador;Masculino;15;9;0;6
MONTAURI;Vereador;Feminino;7;0;0;7
MONTE ALEGRE;Vereador;Masculino;110;18;0;92
MONTE ALEGRE;Vereador;Feminino;60;8;0;52
MONTE ALEGRE DE GOIÁS;Vereador;Masculino;33;7;0;26
MONTE ALEGRE DE GOIÁS;Vereador;Feminino;17;2;0;15
MONTE ALEGRE DE MINAS;Vereador;Masculino;50;9;0;41
MONTE ALEGRE DE MINAS;Vereador;Feminino;18;2;0;16
MONTE ALEGRE DE SERGIPE;Vereador;Masculino;35;8;0;27
MONTE ALEGRE DE SERGIPE;Vereador;Feminino;17;1;0;16
MONTE ALEGRE DO PIAUÍ;Vereador;Masculino;33;9;0;24
MONTE ALEGRE DO PIAUÍ;Vereador;Feminino;17;0;0;17
MONTE ALEGRE DO SUL;Vereador;Masculino;47;8;0;39
MONTE ALEGRE DO SUL;Vereador;Feminino;25;1;0;24
MONTE ALEGRE DOS CAMPOS;Vereador;Masculino;17;8;0;9
MONTE ALEGRE DOS CAMPOS;Vereador;Feminino;8;1;0;7
MONTE ALTO;Vereador;Masculino;96;13;0;83
MONTE ALTO;Vereador;Feminino;44;0;0;44
MONTE APRAZÍVEL;Vereador;Masculino;53;8;0;45
MONTE APRAZÍVEL;Vereador;Feminino;25;1;0;24
MONTE AZUL;Vereador;Masculino;32;8;0;24
MONTE AZUL;Vereador;Feminino;16;3;0;13
MONTE AZUL PAULISTA;Vereador;Masculino;33;8;0;25
MONTE AZUL PAULISTA;Vereador;Feminino;14;3;0;11
MONTE BELO;Vereador;Masculino;44;8;0;36
MONTE BELO;Vereador;Feminino;22;1;0;21
MONTE BELO DO SUL;Vereador;Masculino;18;8;0;10
MONTE BELO DO SUL;Vereador;Feminino;9;1;0;8
MONTE CARLO;Vereador;Masculino;27;6;0;21
MONTE CARLO;Vereador;Feminino;12;3;0;9
MONTE CARMELO;Vereador;Masculino;75;9;0;66
MONTE CARMELO;Vereador;Feminino;38;0;0;38
MONTE CASTELO;Vereador;Masculino;64;14;0;50
MONTE CASTELO;Vereador;Feminino;33;4;0;29
MONTE DAS GAMELEIRAS;Vereador;Masculino;21;6;0;15
MONTE DAS GAMELEIRAS;Vereador;Feminino;13;3;0;10
MONTE DO CARMO;Vereador;Masculino;65;9;0;56
MONTE DO CARMO;Vereador;Feminino;33;0;0;33
MONTE FORMOSO;Vereador;Masculino;24;9;0;15
MONTE FORMOSO;Vereador;Feminino;11;0;0;11
MONTE HOREBE;Vereador;Masculino;20;6;0;14
MONTE HOREBE;Vereador;Feminino;12;3;0;9
MONTE MOR;Vereador;Masculino;99;12;0;87
MONTE MOR;Vereador;Feminino;46;1;0;45
MONTE NEGRO;Vereador;Masculino;49;7;0;42
MONTE NEGRO;Vereador;Feminino;23;2;0;21
MONTE SANTO;Vereador;Masculino;81;12;0;69
MONTE SANTO;Vereador;Feminino;33;3;0;30
MONTE SANTO DE MINAS;Vereador;Masculino;44;9;0;35
MONTE SANTO DE MINAS;Vereador;Feminino;22;2;0;20
MONTE SANTO DO TOCANTINS;Vereador;Masculino;22;9;0;13
MONTE SANTO DO TOCANTINS;Vereador;Feminino;12;0;0;12
MONTE SIÃO;Vereador;Masculino;50;9;0;41
MONTE SIÃO;Vereador;Feminino;25;0;0;25
MONTEIRO;Vereador;Masculino;39;11;0;28
MONTEIRO;Vereador;Feminino;18;2;0;16
MONTEIRO LOBATO;Vereador;Masculino;38;8;0;30
MONTEIRO LOBATO;Vereador;Feminino;18;1;0;17
MONTEIRÓPOLIS;Vereador;Masculino;25;8;0;17
MONTEIRÓPOLIS;Vereador;Feminino;13;1;0;12
MONTENEGRO;Vereador;Masculino;79;9;0;70
MONTENEGRO;Vereador;Feminino;39;1;0;38
MONTES ALTOS;Vereador;Masculino;26;7;0;19
MONTES ALTOS;Vereador;Feminino;15;2;0;13
MONTES CLAROS;Vereador;Masculino;338;22;0;316
MONTES CLAROS;Vereador;Feminino;152;1;0;151
MONTES CLAROS DE GOIÁS;Vereador;Masculino;25;9;0;16
MONTES CLAROS DE GOIÁS;Vereador;Feminino;13;0;0;13
MONTEZUMA;Vereador;Masculino;33;7;0;26
MONTEZUMA;Vereador;Feminino;16;2;0;14
MONTIVIDIU;Vereador;Masculino;50;7;0;43
MONTIVIDIU;Vereador;Feminino;23;2;0;21
MONTIVIDIU DO NORTE;Vereador;Masculino;29;6;0;23
MONTIVIDIU DO NORTE;Vereador;Feminino;15;3;0;12
MORADA NOVA;Vereador;Masculino;55;13;0;42
MORADA NOVA;Vereador;Feminino;24;2;0;22
MORADA NOVA DE MINAS;Vereador;Masculino;42;7;0;35
MORADA NOVA DE MINAS;Vereador;Feminino;27;2;0;25
MORAÚJO;Vereador;Masculino;26;7;0;19
MORAÚJO;Vereador;Feminino;12;2;0;10
MOREILÂNDIA;Vereador;Masculino;22;9;0;13
MOREILÂNDIA;Vereador;Feminino;7;0;0;7
MOREIRA SALES;Vereador;Masculino;33;8;0;25
MOREIRA SALES;Vereador;Feminino;17;1;0;16
MORENO;Vereador;Masculino;99;9;0;90
MORENO;Vereador;Feminino;38;2;0;36
MORMAÇO;Vereador;Masculino;14;7;0;7
MORMAÇO;Vereador;Feminino;10;2;0;8
MORPARÁ;Vereador;Masculino;22;7;0;15
MORPARÁ;Vereador;Feminino;14;2;0;12
MORRETES;Vereador;Masculino;78;9;0;69
MORRETES;Vereador;Feminino;39;2;0;37
MORRINHOS;Vereador;Masculino;121;20;0;101
MORRINHOS;Vereador;Feminino;59;4;0;55
MORRINHOS DO SUL;Vereador;Masculino;16;8;0;8
MORRINHOS DO SUL;Vereador;Feminino;8;1;0;7
MORRO AGUDO;Vereador;Masculino;70;10;0;60
MORRO AGUDO;Vereador;Feminino;33;1;0;32
MORRO AGUDO DE GOIÁS;Vereador;Masculino;22;6;0;16
MORRO AGUDO DE GOIÁS;Vereador;Feminino;13;3;0;10
MORRO CABEÇA NO TEMPO;Vereador;Masculino;22;9;0;13
MORRO CABEÇA NO TEMPO;Vereador;Feminino;10;0;0;10
MORRO DA FUMAÇA;Vereador;Masculino;22;7;0;15
MORRO DA FUMAÇA;Vereador;Feminino;11;2;0;9
MORRO DA GARÇA;Vereador;Masculino;25;8;0;17
MORRO DA GARÇA;Vereador;Feminino;13;1;0;12
MORRO DO CHAPÉU;Vereador;Masculino;46;10;0;36
MORRO DO CHAPÉU;Vereador;Feminino;20;3;0;17
MORRO DO CHAPÉU DO PIAUÍ;Vereador;Masculino;19;7;0;12
MORRO DO CHAPÉU DO PIAUÍ;Vereador;Feminino;10;2;0;8
MORRO DO PILAR;Vereador;Masculino;27;8;0;19
MORRO DO PILAR;Vereador;Feminino;12;1;0;11
MORRO GRANDE;Vereador;Masculino;19;4;0;15
MORRO GRANDE;Vereador;Feminino;12;5;0;7
MORRO REDONDO;Vereador;Masculino;32;6;0;26
MORRO REDONDO;Vereador;Feminino;16;3;0;13
MORRO REUTER;Vereador;Masculino;15;7;0;8
MORRO REUTER;Vereador;Feminino;8;2;0;6
MORROS;Vereador;Masculino;61;8;0;53
MORROS;Vereador;Feminino;31;3;0;28
MORTUGABA;Vereador;Masculino;18;8;0;10
MORTUGABA;Vereador;Feminino;9;1;0;8
MORUNGABA;Vereador;Masculino;64;9;0;55
MORUNGABA;Vereador;Feminino;33;0;0;33
MOSSÂMEDES;Vereador;Masculino;14;8;0;6
MOSSÂMEDES;Vereador;Feminino;7;1;0;6
MOSSORÓ;Vereador;Masculino;187;20;0;167
MOSSORÓ;Vereador;Feminino;86;1;0;85
MOSTARDAS;Vereador;Masculino;42;7;0;35
MOSTARDAS;Vereador;Feminino;22;2;0;20
MOTUCA;Vereador;Masculino;50;6;0;44
MOTUCA;Vereador;Feminino;26;3;0;23
MOZARLÂNDIA;Vereador;Masculino;34;7;0;27
MOZARLÂNDIA;Vereador;Feminino;19;2;0;17
MUANÁ;Vereador;Masculino;53;7;0;46
MUANÁ;Vereador;Feminino;28;2;0;26
MUCAJAÍ;Vereador;Masculino;46;8;0;38
MUCAJAÍ;Vereador;Feminino;23;1;0;22
MUCAMBO;Vereador;Masculino;25;7;0;18
MUCAMBO;Vereador;Feminino;17;2;0;15
MUCUGÊ;Vereador;Masculino;25;8;0;17
MUCUGÊ;Vereador;Feminino;12;1;0;11
MUÇUM;Vereador;Masculino;27;9;0;18
MUÇUM;Vereador;Feminino;11;0;0;11
MUCURI;Vereador;Masculino;110;13;0;97
MUCURI;Vereador;Feminino;54;0;0;54
MUCURICI;Vereador;Masculino;30;9;0;21
MUCURICI;Vereador;Feminino;14;0;0;14
MUITOS CAPÕES;Vereador;Masculino;18;6;0;12
MUITOS CAPÕES;Vereador;Feminino;9;3;0;6
MULITERNO;Vereador;Masculino;16;9;0;7
MULITERNO;Vereador;Feminino;6;0;0;6
MULUNGU;Vereador;Masculino;52;14;0;38
MULUNGU;Vereador;Feminino;25;4;0;21
MULUNGU DO MORRO;Vereador;Masculino;25;8;0;17
MULUNGU DO MORRO;Vereador;Feminino;13;1;0;12
MUNDO NOVO;Vereador;Masculino;102;26;0;76
MUNDO NOVO;Vereador;Feminino;46;5;0;41
MUNHOZ;Vereador;Masculino;21;8;0;13
MUNHOZ;Vereador;Feminino;9;1;0;8
MUNHOZ DE MELO;Vereador;Masculino;23;7;0;16
MUNHOZ DE MELO;Vereador;Feminino;12;2;0;10
MUNIZ FERREIRA;Vereador;Masculino;34;7;0;27
MUNIZ FERREIRA;Vereador;Feminino;13;2;0;11
MUNIZ FREIRE;Vereador;Masculino;60;9;0;51
MUNIZ FREIRE;Vereador;Feminino;27;0;0;27
MUQUÉM DO SÃO FRANCISCO;Vereador;Masculino;26;5;0;21
MUQUÉM DO SÃO FRANCISCO;Vereador;Feminino;11;4;0;7
MUQUI;Vereador;Masculino;70;9;0;61
MUQUI;Vereador;Feminino;35;0;0;35
MURIAÉ;Vereador;Masculino;114;10;0;104
MURIAÉ;Vereador;Feminino;54;1;0;53
MURIBECA;Vereador;Masculino;24;7;0;17
MURIBECA;Vereador;Feminino;12;2;0;10
MURICI;Vereador;Masculino;29;10;0;19
MURICI;Vereador;Feminino;14;1;0;13
MURICI DOS PORTELAS;Vereador;Masculino;23;8;0;15
MURICI DOS PORTELAS;Vereador;Feminino;15;1;0;14
MURICILÂNDIA;Vereador;Masculino;28;8;0;20
MURICILÂNDIA;Vereador;Feminino;13;1;0;12
MURITIBA;Vereador;Masculino;81;11;0;70
MURITIBA;Vereador;Feminino;38;0;0;38
MURUTINGA DO SUL;Vereador;Masculino;18;9;0;9
MURUTINGA DO SUL;Vereador;Feminino;9;0;0;9
MUTUÍPE;Vereador;Masculino;40;9;0;31
MUTUÍPE;Vereador;Feminino;18;2;0;16
MUTUM;Vereador;Masculino;58;10;0;48
MUTUM;Vereador;Feminino;27;1;0;26
MUTUNÓPOLIS;Vereador;Masculino;30;5;0;25
MUTUNÓPOLIS;Vereador;Feminino;15;4;0;11
MUZAMBINHO;Vereador;Masculino;72;10;0;62
MUZAMBINHO;Vereador;Feminino;35;1;0;34
NACIP RAYDAN;Vereador;Masculino;27;8;0;19
NACIP RAYDAN;Vereador;Feminino;14;1;0;13
NANTES;Vereador;Masculino;38;8;0;30
NANTES;Vereador;Feminino;18;1;0;17
NANUQUE;Vereador;Masculino;88;11;0;77
NANUQUE;Vereador;Feminino;43;2;0;41
NÃO-ME-TOQUE;Vereador;Masculino;23;8;0;15
NÃO-ME-TOQUE;Vereador;Feminino;12;1;0;11
NAQUE;Vereador;Masculino;42;8;0;34
NAQUE;Vereador;Feminino;21;1;0;20
NARANDIBA;Vereador;Masculino;30;9;0;21
NARANDIBA;Vereador;Feminino;13;0;0;13
NATAL;Vereador;Masculino;311;25;0;286
NATAL;Vereador;Feminino;139;4;0;135
NATALÂNDIA;Vereador;Masculino;29;9;0;20
NATALÂNDIA;Vereador;Feminino;14;0;0;14
NATÉRCIA;Vereador;Masculino;36;7;0;29
NATÉRCIA;Vereador;Feminino;19;2;0;17
NATIVIDADE;Vereador;Masculino;115;18;0;97
NATIVIDADE;Vereador;Feminino;58;2;0;56
NATIVIDADE DA SERRA;Vereador;Masculino;57;8;0;49
NATIVIDADE DA SERRA;Vereador;Feminino;25;1;0;24
NATUBA;Vereador;Masculino;22;9;0;13
NATUBA;Vereador;Feminino;11;0;0;11
NAVEGANTES;Vereador;Masculino;69;9;0;60
NAVEGANTES;Vereador;Feminino;29;1;0;28
NAVIRAÍ;Vereador;Masculino;63;12;0;51
NAVIRAÍ;Vereador;Feminino;29;1;0;28
NAZARÉ;Vereador;Masculino;101;16;0;85
NAZARÉ;Vereador;Feminino;41;4;0;37
NAZARÉ DA MATA;Vereador;Masculino;66;11;0;55
NAZARÉ DA MATA;Vereador;Feminino;26;2;0;24
NAZARÉ DO PIAUÍ;Vereador;Masculino;24;7;0;17
NAZARÉ DO PIAUÍ;Vereador;Feminino;12;2;0;10
NAZARÉ PAULISTA;Vereador;Masculino;73;11;0;62
NAZARÉ PAULISTA;Vereador;Feminino;36;0;0;36
NAZARENO;Vereador;Masculino;32;7;0;25
NAZARENO;Vereador;Feminino;18;2;0;16
NAZAREZINHO;Vereador;Masculino;23;8;0;15
NAZAREZINHO;Vereador;Feminino;11;1;0;10
NAZÁRIA;Vereador;Masculino;55;8;0;47
NAZÁRIA;Vereador;Feminino;28;1;0;27
NAZÁRIO;Vereador;Masculino;34;8;0;26
NAZÁRIO;Vereador;Feminino;17;1;0;16
NEÓPOLIS;Vereador;Masculino;44;9;0;35
NEÓPOLIS;Vereador;Feminino;19;2;0;17
NEPOMUCENO;Vereador;Masculino;79;10;0;69
NEPOMUCENO;Vereador;Feminino;40;1;0;39
NERÓPOLIS;Vereador;Masculino;58;10;0;48
NERÓPOLIS;Vereador;Feminino;21;1;0;20
NEVES PAULISTA;Vereador;Masculino;30;9;0;21
NEVES PAULISTA;Vereador;Feminino;14;0;0;14
NHAMUNDÁ;Vereador;Masculino;49;8;0;41
NHAMUNDÁ;Vereador;Feminino;22;1;0;21
NHANDEARA;Vereador;Masculino;40;8;0;32
NHANDEARA;Vereador;Feminino;20;1;0;19
NICOLAU VERGUEIRO;Vereador;Masculino;13;8;0;5
NICOLAU VERGUEIRO;Vereador;Feminino;6;1;0;5
NILO PEÇANHA;Vereador;Masculino;45;8;0;37
NILO PEÇANHA;Vereador;Feminino;22;1;0;21
NILÓPOLIS;Vereador;Masculino;152;11;0;141
NILÓPOLIS;Vereador;Feminino;58;1;0;57
NINA RODRIGUES;Vereador;Masculino;17;5;0;12
NINA RODRIGUES;Vereador;Feminino;14;4;0;10
NINHEIRA;Vereador;Masculino;22;8;0;14
NINHEIRA;Vereador;Feminino;9;1;0;8
NIOAQUE;Vereador;Masculino;60;8;0;52
NIOAQUE;Vereador;Feminino;29;1;0;28
NIPOÃ;Vereador;Masculino;40;8;0;32
NIPOÃ;Vereador;Feminino;22;1;0;21
NIQUELÂNDIA;Vereador;Masculino;128;13;0;115
NIQUELÂNDIA;Vereador;Feminino;58;0;0;58
NÍSIA FLORESTA;Vereador;Masculino;38;9;0;29
NÍSIA FLORESTA;Vereador;Feminino;25;2;0;23
NITERÓI;Vereador;Masculino;286;18;0;268
NITERÓI;Vereador;Feminino;126;3;0;123
NOBRES;Vereador;Masculino;42;10;0;32
NOBRES;Vereador;Feminino;17;1;0;16
NONOAI;Vereador;Masculino;21;7;0;14
NONOAI;Vereador;Feminino;11;2;0;9
NORDESTINA;Vereador;Masculino;28;8;0;20
NORDESTINA;Vereador;Feminino;8;1;0;7
NORMANDIA;Vereador;Masculino;27;7;0;20
NORMANDIA;Vereador;Feminino;14;2;0;12
NORTELÂNDIA;Vereador;Masculino;24;9;0;15
NORTELÂNDIA;Vereador;Feminino;9;0;0;9
NOSSA SENHORA APARECIDA;Vereador;Masculino;21;7;0;14
NOSSA SENHORA APARECIDA;Vereador;Feminino;11;2;0;9
NOSSA SENHORA DA GLÓRIA;Vereador;Masculino;31;7;0;24
NOSSA SENHORA DA GLÓRIA;Vereador;Feminino;18;6;0;12
NOSSA SENHORA DAS DORES;Vereador;Masculino;40;11;0;29
NOSSA SENHORA DAS DORES;Vereador;Feminino;22;0;0;22
NOSSA SENHORA DAS GRAÇAS;Vereador;Masculino;23;9;0;14
NOSSA SENHORA DAS GRAÇAS;Vereador;Feminino;11;0;0;11
NOSSA SENHORA DE LOURDES;Vereador;Masculino;22;8;0;14
NOSSA SENHORA DE LOURDES;Vereador;Feminino;13;1;0;12
NOSSA SENHORA DE NAZARÉ;Vereador;Masculino;19;8;0;11
NOSSA SENHORA DE NAZARÉ;Vereador;Feminino;9;1;0;8
NOSSA SENHORA DO LIVRAMENTO;Vereador;Masculino;41;9;0;32
NOSSA SENHORA DO LIVRAMENTO;Vereador;Feminino;13;0;0;13
NOSSA SENHORA DO SOCORRO;Vereador;Masculino;182;18;0;164
NOSSA SENHORA DO SOCORRO;Vereador;Feminino;75;3;0;72
NOSSA SENHORA DOS REMÉDIOS;Vereador;Masculino;39;9;0;30
NOSSA SENHORA DOS REMÉDIOS;Vereador;Feminino;23;0;0;23
NOVA ALIANÇA;Vereador;Masculino;23;7;0;16
NOVA ALIANÇA;Vereador;Feminino;10;2;0;8
NOVA ALIANÇA DO IVAÍ;Vereador;Masculino;20;7;0;13
NOVA ALIANÇA DO IVAÍ;Vereador;Feminino;10;2;0;8
NOVA ALVORADA;Vereador;Masculino;18;7;0;11
NOVA ALVORADA;Vereador;Feminino;9;2;0;7
NOVA ALVORADA DO SUL;Vereador;Masculino;49;10;0;39
NOVA ALVORADA DO SUL;Vereador;Feminino;24;1;0;23
NOVA AMÉRICA;Vereador;Masculino;24;7;0;17
NOVA AMÉRICA;Vereador;Feminino;15;2;0;13
NOVA AMÉRICA DA COLINA;Vereador;Masculino;25;7;0;18
NOVA AMÉRICA DA COLINA;Vereador;Feminino;13;2;0;11
NOVA ANDRADINA;Vereador;Masculino;54;13;0;41
NOVA ANDRADINA;Vereador;Feminino;23;0;0;23
NOVA ARAÇÁ;Vereador;Masculino;14;8;0;6
NOVA ARAÇÁ;Vereador;Feminino;6;1;0;5
NOVA AURORA;Vereador;Masculino;29;14;0;15
NOVA AURORA;Vereador;Feminino;15;4;0;11
NOVA BANDEIRANTES;Vereador;Masculino;56;6;0;50
NOVA BANDEIRANTES;Vereador;Feminino;23;3;0;20
NOVA BASSANO;Vereador;Masculino;18;8;0;10
NOVA BASSANO;Vereador;Feminino;9;1;0;8
NOVA BELÉM;Vereador;Masculino;22;8;0;14
NOVA BELÉM;Vereador;Feminino;11;1;0;10
NOVA BOA VISTA;Vereador;Masculino;17;6;0;11
NOVA BOA VISTA;Vereador;Feminino;8;3;0;5
NOVA BRASILÂNDIA;Vereador;Masculino;21;6;0;15
NOVA BRASILÂNDIA;Vereador;Feminino;8;3;0;5
NOVA BRASILÂNDIA DO OESTE;Vereador;Masculino;50;8;0;42
NOVA BRASILÂNDIA DO OESTE;Vereador;Feminino;23;1;0;22
NOVA BRÉSCIA;Vereador;Masculino;16;7;0;9
NOVA BRÉSCIA;Vereador;Feminino;7;2;0;5
NOVA CAMPINA;Vereador;Masculino;59;6;0;53
NOVA CAMPINA;Vereador;Feminino;26;3;0;23
NOVA CANAÃ;Vereador;Masculino;33;9;0;24
NOVA CANAÃ;Vereador;Feminino;15;2;0;13
NOVA CANAÃ DO NORTE;Vereador;Masculino;33;7;0;26
NOVA CANAÃ DO NORTE;Vereador;Feminino;16;2;0;14
NOVA CANAÃ PAULISTA;Vereador;Masculino;22;8;0;14
NOVA CANAÃ PAULISTA;Vereador;Feminino;11;1;0;10
NOVA CANDELÁRIA;Vereador;Masculino;12;7;0;5
NOVA CANDELÁRIA;Vereador;Feminino;6;2;0;4
NOVA CANTU;Vereador;Masculino;33;7;0;26
NOVA CANTU;Vereador;Feminino;16;2;0;14
NOVA CASTILHO;Vereador;Masculino;15;8;0;7
NOVA CASTILHO;Vereador;Feminino;8;1;0;7
NOVA COLINAS;Vereador;Masculino;20;7;0;13
NOVA COLINAS;Vereador;Feminino;11;2;0;9
NOVA CRIXÁS;Vereador;Masculino;37;8;0;29
NOVA CRIXÁS;Vereador;Feminino;16;1;0;15
NOVA CRUZ;Vereador;Masculino;45;12;0;33
NOVA CRUZ;Vereador;Feminino;21;1;0;20
NOVA ERA;Vereador;Masculino;65;8;0;57
NOVA ERA;Vereador;Feminino;30;1;0;29
NOVA ERECHIM;Vereador;Masculino;20;8;0;12
NOVA ERECHIM;Vereador;Feminino;12;1;0;11
NOVA ESPERANÇA;Vereador;Masculino;47;8;0;39
NOVA ESPERANÇA;Vereador;Feminino;28;1;0;27
NOVA ESPERANÇA DO PIRIÁ;Vereador;Masculino;24;8;0;16
NOVA ESPERANÇA DO PIRIÁ;Vereador;Feminino;13;1;0;12
NOVA ESPERANÇA DO SUDOESTE;Vereador;Masculino;24;8;0;16
NOVA ESPERANÇA DO SUDOESTE;Vereador;Feminino;3;1;0;2
NOVA ESPERANÇA DO SUL;Vereador;Masculino;20;8;0;12
NOVA ESPERANÇA DO SUL;Vereador;Feminino;10;1;0;9
NOVA EUROPA;Vereador;Masculino;47;6;0;41
NOVA EUROPA;Vereador;Feminino;24;3;0;21
NOVA FÁTIMA;Vereador;Masculino;47;16;0;31
NOVA FÁTIMA;Vereador;Feminino;23;2;0;21
NOVA FLORESTA;Vereador;Masculino;30;8;0;22
NOVA FLORESTA;Vereador;Feminino;16;1;0;15
NOVA FRIBURGO;Vereador;Masculino;222;20;0;202
NOVA FRIBURGO;Vereador;Feminino;102;1;0;101
NOVA GLÓRIA;Vereador;Masculino;22;7;0;15
NOVA GLÓRIA;Vereador;Feminino;11;2;0;9
NOVA GRANADA;Vereador;Masculino;68;9;0;59
NOVA GRANADA;Vereador;Feminino;33;0;0;33
NOVA GUARITA;Vereador;Masculino;20;7;0;13
NOVA GUARITA;Vereador;Feminino;9;2;0;7
NOVA GUATAPORANGA;Vereador;Masculino;23;9;0;14
NOVA GUATAPORANGA;Vereador;Feminino;11;0;0;11
NOVA HARTZ;Vereador;Masculino;59;10;0;49
NOVA HARTZ;Vereador;Feminino;31;1;0;30
NOVA IBIÁ;Vereador;Masculino;36;8;0;28
NOVA IBIÁ;Vereador;Feminino;15;1;0;14
NOVA IGUAÇU;Vereador;Masculino;560;28;0;532
NOVA IGUAÇU;Vereador;Feminino;214;1;0;213
NOVA IGUAÇU DE GOIÁS;Vereador;Masculino;20;8;0;12
NOVA IGUAÇU DE GOIÁS;Vereador;Feminino;13;1;0;12
NOVA INDEPENDÊNCIA;Vereador;Masculino;35;8;0;27
NOVA INDEPENDÊNCIA;Vereador;Feminino;21;1;0;20
NOVA IORQUE;Vereador;Masculino;17;8;0;9
NOVA IORQUE;Vereador;Feminino;10;1;0;9
NOVA IPIXUNA;Vereador;Masculino;50;7;0;43
NOVA IPIXUNA;Vereador;Feminino;27;2;0;25
NOVA ITABERABA;Vereador;Masculino;32;9;0;23
NOVA ITABERABA;Vereador;Feminino;16;0;0;16
NOVA ITARANA;Vereador;Masculino;18;7;0;11
NOVA ITARANA;Vereador;Feminino;11;2;0;9
NOVA LACERDA;Vereador;Masculino;41;9;0;32
NOVA LACERDA;Vereador;Feminino;19;0;0;19
NOVA LARANJEIRAS;Vereador;Masculino;32;7;0;25
NOVA LARANJEIRAS;Vereador;Feminino;14;2;0;12
NOVA LIMA;Vereador;Masculino;133;9;0;124
NOVA LIMA;Vereador;Feminino;59;1;0;58
NOVA LONDRINA;Vereador;Masculino;52;8;0;44
NOVA LONDRINA;Vereador;Feminino;27;1;0;26
NOVA LUZITÂNIA;Vereador;Masculino;40;7;0;33
NOVA LUZITÂNIA;Vereador;Feminino;18;2;0;16
NOVA MAMORÉ;Vereador;Masculino;76;11;0;65
NOVA MAMORÉ;Vereador;Feminino;35;0;0;35
NOVA MARILÂNDIA;Vereador;Masculino;20;9;0;11
NOVA MARILÂNDIA;Vereador;Feminino;3;0;0;3
NOVA MARINGÁ;Vereador;Masculino;28;9;0;19
NOVA MARINGÁ;Vereador;Feminino;14;0;0;14
NOVA MÓDICA;Vereador;Masculino;23;6;0;17
NOVA MÓDICA;Vereador;Feminino;9;3;0;6
NOVA MONTE VERDE;Vereador;Masculino;43;5;0;38
NOVA MONTE VERDE;Vereador;Feminino;21;4;0;17
NOVA MUTUM;Vereador;Masculino;30;8;0;22
NOVA MUTUM;Vereador;Feminino;16;1;0;15
NOVA NAZARÉ;Vereador;Masculino;37;7;0;30
NOVA NAZARÉ;Vereador;Feminino;17;2;0;15
NOVA ODESSA;Vereador;Masculino;94;8;0;86
NOVA ODESSA;Vereador;Feminino;49;1;0;48
NOVA OLÍMPIA;Vereador;Masculino;73;16;0;57
NOVA OLÍMPIA;Vereador;Feminino;35;2;0;33
NOVA OLINDA;Vereador;Masculino;43;24;0;19
NOVA OLINDA;Vereador;Feminino;25;3;0;22
NOVA OLINDA DO MARANHÃO;Vereador;Masculino;30;7;0;23
NOVA OLINDA DO MARANHÃO;Vereador;Feminino;14;4;0;10
NOVA OLINDA DO NORTE;Vereador;Masculino;89;12;0;77
NOVA OLINDA DO NORTE;Vereador;Feminino;40;1;0;39
NOVA PÁDUA;Vereador;Masculino;22;7;0;15
NOVA PÁDUA;Vereador;Feminino;4;2;0;2
NOVA PALMA;Vereador;Masculino;16;8;0;8
NOVA PALMA;Vereador;Feminino;8;1;0;7
NOVA PALMEIRA;Vereador;Masculino;14;8;0;6
NOVA PALMEIRA;Vereador;Feminino;9;1;0;8
NOVA PETRÓPOLIS;Vereador;Masculino;45;10;0;35
NOVA PETRÓPOLIS;Vereador;Feminino;23;1;0;22
NOVA PONTE;Vereador;Masculino;54;7;0;47
NOVA PONTE;Vereador;Feminino;27;2;0;25
NOVA PORTEIRINHA;Vereador;Masculino;42;8;0;34
NOVA PORTEIRINHA;Vereador;Feminino;21;1;0;20
NOVA PRATA;Vereador;Masculino;54;11;0;43
NOVA PRATA;Vereador;Feminino;25;0;0;25
NOVA PRATA DO IGUAÇU;Vereador;Masculino;26;7;0;19
NOVA PRATA DO IGUAÇU;Vereador;Feminino;6;2;0;4
NOVA RAMADA;Vereador;Masculino;19;8;0;11
NOVA RAMADA;Vereador;Feminino;9;1;0;8
NOVA REDENÇÃO;Vereador;Masculino;30;8;0;22
NOVA REDENÇÃO;Vereador;Feminino;14;1;0;13
NOVA RESENDE;Vereador;Masculino;50;6;0;44
NOVA RESENDE;Vereador;Feminino;27;3;0;24
NOVA ROMA;Vereador;Masculino;20;8;0;12
NOVA ROMA;Vereador;Feminino;11;1;0;10
NOVA ROMA DO SUL;Vereador;Masculino;16;9;0;7
NOVA ROMA DO SUL;Vereador;Feminino;9;0;0;9
NOVA ROSALÂNDIA;Vereador;Masculino;23;8;0;15
NOVA ROSALÂNDIA;Vereador;Feminino;10;1;0;9
NOVA RUSSAS;Vereador;Masculino;57;6;0;51
NOVA RUSSAS;Vereador;Feminino;27;7;0;20
NOVA SANTA BÁRBARA;Vereador;Masculino;21;7;0;14
NOVA SANTA BÁRBARA;Vereador;Feminino;11;2;0;9
NOVA SANTA HELENA;Vereador;Masculino;20;8;0;12
NOVA SANTA HELENA;Vereador;Feminino;11;1;0;10
NOVA SANTA RITA;Vereador;Masculino;73;19;0;54
NOVA SANTA RITA;Vereador;Feminino;36;1;0;35
NOVA SANTA ROSA;Vereador;Masculino;23;7;0;16
NOVA SANTA ROSA;Vereador;Feminino;12;2;0;10
NOVA SERRANA;Vereador;Masculino;123;12;0;111
NOVA SERRANA;Vereador;Feminino;58;1;0;57
NOVA SOURE;Vereador;Masculino;40;11;0;29
NOVA SOURE;Vereador;Feminino;17;0;0;17
NOVA TEBAS;Vereador;Masculino;35;5;0;30
NOVA TEBAS;Vereador;Feminino;23;4;0;19
NOVA TIMBOTEUA;Vereador;Masculino;46;8;0;38
NOVA TIMBOTEUA;Vereador;Feminino;23;1;0;22
NOVA TRENTO;Vereador;Masculino;32;9;0;23
NOVA TRENTO;Vereador;Feminino;18;0;0;18
NOVA UBIRATÃ;Vereador;Masculino;24;9;0;15
NOVA UBIRATÃ;Vereador;Feminino;10;0;0;10
NOVA UNIÃO;Vereador;Masculino;78;15;0;63
NOVA UNIÃO;Vereador;Feminino;41;3;0;38
NOVA VENÉCIA;Vereador;Masculino;92;11;0;81
NOVA VENÉCIA;Vereador;Feminino;41;2;0;39
NOVA VENEZA;Vereador;Masculino;75;18;0;57
NOVA VENEZA;Vereador;Feminino;40;0;0;40
NOVA VIÇOSA;Vereador;Masculino;91;12;0;79
NOVA VIÇOSA;Vereador;Feminino;38;1;0;37
NOVA XAVANTINA;Vereador;Masculino;37;10;0;27
NOVA XAVANTINA;Vereador;Feminino;17;1;0;16
NOVAIS;Vereador;Masculino;22;9;0;13
NOVAIS;Vereador;Feminino;12;0;0;12
NOVO ACORDO;Vereador;Masculino;31;9;0;22
NOVO ACORDO;Vereador;Feminino;12;0;0;12
NOVO AIRÃO;Vereador;Masculino;75;6;0;69
NOVO AIRÃO;Vereador;Feminino;36;3;0;33
NOVO ALEGRE;Vereador;Masculino;22;7;0;15
NOVO ALEGRE;Vereador;Feminino;10;2;0;8
NOVO ARIPUANÃ;Vereador;Masculino;89;9;0;80
NOVO ARIPUANÃ;Vereador;Feminino;51;2;0;49
NOVO BARREIRO;Vereador;Masculino;21;7;0;14
NOVO BARREIRO;Vereador;Feminino;10;2;0;8
NOVO BRASIL;Vereador;Masculino;19;8;0;11
NOVO BRASIL;Vereador;Feminino;9;1;0;8
NOVO CABRAIS;Vereador;Masculino;22;7;0;15
NOVO CABRAIS;Vereador;Feminino;15;2;0;13
NOVO CRUZEIRO;Vereador;Masculino;84;13;0;71
NOVO CRUZEIRO;Vereador;Feminino;33;0;0;33
NOVO GAMA;Vereador;Masculino;125;11;0;114
NOVO GAMA;Vereador;Feminino;50;2;0;48
NOVO HAMBURGO;Vereador;Masculino;114;13;0;101
NOVO HAMBURGO;Vereador;Feminino;56;1;0;55
NOVO HORIZONTE;Vereador;Masculino;129;26;0;103
NOVO HORIZONTE;Vereador;Feminino;60;5;0;55
NOVO HORIZONTE DO NORTE;Vereador;Masculino;24;9;0;15
NOVO HORIZONTE DO NORTE;Vereador;Feminino;10;0;0;10
NOVO HORIZONTE DO OESTE;Vereador;Masculino;38;7;0;31
NOVO HORIZONTE DO OESTE;Vereador;Feminino;20;2;0;18
NOVO HORIZONTE DO SUL;Vereador;Masculino;26;8;0;18
NOVO HORIZONTE DO SUL;Vereador;Feminino;14;1;0;13
NOVO ITACOLOMI;Vereador;Masculino;41;9;0;32
NOVO ITACOLOMI;Vereador;Feminino;20;0;0;20
NOVO JARDIM;Vereador;Masculino;19;6;0;13
NOVO JARDIM;Vereador;Feminino;15;3;0;12
NOVO LINO;Vereador;Masculino;44;8;0;36
NOVO LINO;Vereador;Feminino;20;1;0;19
NOVO MACHADO;Vereador;Masculino;16;8;0;8
NOVO MACHADO;Vereador;Feminino;7;1;0;6
NOVO MUNDO;Vereador;Masculino;32;9;0;23
NOVO MUNDO;Vereador;Feminino;18;0;0;18
NOVO ORIENTE;Vereador;Masculino;26;7;0;19
NOVO ORIENTE;Vereador;Feminino;14;4;0;10
NOVO ORIENTE DE MINAS;Vereador;Masculino;52;7;0;45
NOVO ORIENTE DE MINAS;Vereador;Feminino;25;2;0;23
NOVO ORIENTE DO PIAUÍ;Vereador;Masculino;20;7;0;13
NOVO ORIENTE DO PIAUÍ;Vereador;Feminino;10;2;0;8
NOVO PLANALTO;Vereador;Masculino;22;8;0;14
NOVO PLANALTO;Vereador;Feminino;12;1;0;11
NOVO PROGRESSO;Vereador;Masculino;51;9;0;42
NOVO PROGRESSO;Vereador;Feminino;26;0;0;26
NOVO REPARTIMENTO;Vereador;Masculino;71;10;0;61
NOVO REPARTIMENTO;Vereador;Feminino;33;3;0;30
NOVO SANTO ANTÔNIO;Vereador;Masculino;42;16;0;26
NOVO SANTO ANTÔNIO;Vereador;Feminino;22;2;0;20
NOVO SÃO JOAQUIM;Vereador;Masculino;27;9;0;18
NOVO SÃO JOAQUIM;Vereador;Feminino;13;0;0;13
NOVO TIRADENTES;Vereador;Masculino;22;8;0;14
NOVO TIRADENTES;Vereador;Feminino;11;1;0;10
NOVO TRIUNFO;Vereador;Masculino;19;10;0;9
NOVO TRIUNFO;Vereador;Feminino;12;1;0;11
NOVO XINGU;Vereador;Masculino;15;7;0;8
NOVO XINGU;Vereador;Feminino;7;2;0;5
NOVORIZONTE;Vereador;Masculino;35;8;0;27
NOVORIZONTE;Vereador;Feminino;18;1;0;17
NUPORANGA;Vereador;Masculino;29;8;0;21
NUPORANGA;Vereador;Feminino;15;1;0;14
ÓBIDOS;Vereador;Masculino;88;9;0;79
ÓBIDOS;Vereador;Feminino;39;4;0;35
OCARA;Vereador;Masculino;43;11;0;32
OCARA;Vereador;Feminino;20;0;0;20
OCAUÇU;Vereador;Masculino;27;8;0;19
OCAUÇU;Vereador;Feminino;11;1;0;10
OEIRAS;Vereador;Masculino;36;10;0;26
OEIRAS;Vereador;Feminino;17;1;0;16
OEIRAS DO PARÁ;Vereador;Masculino;52;7;0;45
OEIRAS DO PARÁ;Vereador;Feminino;24;4;0;20
OIAPOQUE;Vereador;Masculino;84;9;0;75
OIAPOQUE;Vereador;Feminino;33;2;0;31
OLARIA;Vereador;Masculino;20;7;0;13
OLARIA;Vereador;Feminino;10;2;0;8
ÓLEO;Vereador;Masculino;23;8;0;15
ÓLEO;Vereador;Feminino;12;1;0;11
OLHO D'ÁGUA;Vereador;Masculino;19;9;0;10
OLHO D'ÁGUA;Vereador;Feminino;8;0;0;8
OLHO D'ÁGUA DAS CUNHÃS;Vereador;Masculino;35;9;0;26
OLHO D'ÁGUA DAS CUNHÃS;Vereador;Feminino;16;2;0;14
OLHO D'ÁGUA DAS FLORES;Vereador;Masculino;52;10;0;42
OLHO D'ÁGUA DAS FLORES;Vereador;Feminino;23;1;0;22
OLHO D'ÁGUA DO BORGES;Vereador;Masculino;11;5;0;6
OLHO D'ÁGUA DO BORGES;Vereador;Feminino;8;4;0;4
OLHO D'ÁGUA DO CASADO;Vereador;Masculino;26;8;0;18
OLHO D'ÁGUA DO CASADO;Vereador;Feminino;12;1;0;11
OLHO D'ÁGUA DO PIAUÍ;Vereador;Masculino;16;8;0;8
OLHO D'ÁGUA DO PIAUÍ;Vereador;Feminino;9;1;0;8
OLHO D'ÁGUA GRANDE;Vereador;Masculino;20;7;0;13
OLHO D'ÁGUA GRANDE;Vereador;Feminino;13;2;0;11
OLHOS D'ÁGUA;Vereador;Masculino;34;6;0;28
OLHOS D'ÁGUA;Vereador;Feminino;18;3;0;15
OLÍMPIA;Vereador;Masculino;72;10;0;62
OLÍMPIA;Vereador;Feminino;30;0;0;30
OLÍMPIO NORONHA;Vereador;Masculino;27;9;0;18
OLÍMPIO NORONHA;Vereador;Feminino;16;0;0;16
OLINDA;Vereador;Masculino;237;15;0;222
OLINDA;Vereador;Feminino;82;2;0;80
OLINDA NOVA DO MARANHÃO;Vereador;Masculino;52;7;0;45
OLINDA NOVA DO MARANHÃO;Vereador;Feminino;27;2;0;25
OLINDINA;Vereador;Masculino;54;10;0;44
OLINDINA;Vereador;Feminino;18;1;0;17
OLIVEDOS;Vereador;Masculino;23;8;0;15
OLIVEDOS;Vereador;Feminino;12;1;0;11
OLIVEIRA;Vereador;Masculino;95;13;0;82
OLIVEIRA;Vereador;Feminino;41;0;0;41
OLIVEIRA DE FÁTIMA;Vereador;Masculino;20;7;0;13
OLIVEIRA DE FÁTIMA;Vereador;Feminino;8;2;0;6
OLIVEIRA DOS BREJINHOS;Vereador;Masculino;18;11;0;7
OLIVEIRA DOS BREJINHOS;Vereador;Feminino;10;0;0;10
OLIVEIRA FORTES;Vereador;Masculino;27;9;0;18
OLIVEIRA FORTES;Vereador;Feminino;12;0;0;12
OLIVENÇA;Vereador;Masculino;23;5;0;18
OLIVENÇA;Vereador;Feminino;11;4;0;7
ONÇA DE PITANGUI;Vereador;Masculino;35;9;0;26
ONÇA DE PITANGUI;Vereador;Feminino;23;0;0;23
ONDA VERDE;Vereador;Masculino;38;9;0;29
ONDA VERDE;Vereador;Feminino;19;0;0;19
ORATÓRIOS;Vereador;Masculino;41;9;0;32
ORATÓRIOS;Vereador;Feminino;19;0;0;19
ORIENTE;Vereador;Masculino;57;9;0;48
ORIENTE;Vereador;Feminino;29;0;0;29
ORINDIÚVA;Vereador;Masculino;45;7;0;38
ORINDIÚVA;Vereador;Feminino;20;2;0;18
ORIXIMINÁ;Vereador;Masculino;52;13;0;39
ORIXIMINÁ;Vereador;Feminino;21;2;0;19
ORIZÂNIA;Vereador;Masculino;32;8;0;24
ORIZÂNIA;Vereador;Feminino;17;1;0;16
ORIZONA;Vereador;Masculino;29;8;0;21
ORIZONA;Vereador;Feminino;13;1;0;12
ORLÂNDIA;Vereador;Masculino;67;8;0;59
ORLÂNDIA;Vereador;Feminino;32;1;0;31
ORLEANS;Vereador;Masculino;33;9;0;24
ORLEANS;Vereador;Feminino;19;2;0;17
OROBÓ;Vereador;Masculino;25;9;0;16
OROBÓ;Vereador;Feminino;5;2;0;3
OROCÓ;Vereador;Masculino;20;7;0;13
OROCÓ;Vereador;Feminino;9;2;0;7
ORÓS;Vereador;Masculino;26;7;0;19
ORÓS;Vereador;Feminino;13;4;0;9
ORTIGUEIRA;Vereador;Masculino;49;11;0;38
ORTIGUEIRA;Vereador;Feminino;24;0;0;24
OSASCO;Vereador;Masculino;283;18;0;265
OSASCO;Vereador;Feminino;128;3;0;125
OSCAR BRESSANE;Vereador;Masculino;17;6;0;11
OSCAR BRESSANE;Vereador;Feminino;12;3;0;9
OSÓRIO;Vereador;Masculino;35;7;0;28
OSÓRIO;Vereador;Feminino;18;2;0;16
OSVALDO CRUZ;Vereador;Masculino;91;12;0;79
OSVALDO CRUZ;Vereador;Feminino;43;1;0;42
OTACÍLIO COSTA;Vereador;Masculino;47;9;0;38
OTACÍLIO COSTA;Vereador;Feminino;23;2;0;21
OURÉM;Vereador;Masculino;49;8;0;41
OURÉM;Vereador;Feminino;24;1;0;23
OURIÇANGAS;Vereador;Masculino;36;7;0;29
OURIÇANGAS;Vereador;Feminino;16;2;0;14
OURICURI;Vereador;Masculino;87;12;0;75
OURICURI;Vereador;Feminino;40;1;0;39
OURILÂNDIA DO NORTE;Vereador;Masculino;59;10;0;49
OURILÂNDIA DO NORTE;Vereador;Feminino;19;1;0;18
OURINHOS;Vereador;Masculino;87;11;0;76
OURINHOS;Vereador;Feminino;43;0;0;43
OURIZONA;Vereador;Masculino;25;7;0;18
OURIZONA;Vereador;Feminino;13;2;0;11
OURO;Vereador;Masculino;18;8;0;10
OURO;Vereador;Feminino;8;1;0;7
OURO BRANCO;Vereador;Masculino;129;25;0;104
OURO BRANCO;Vereador;Feminino;68;6;0;62
OURO FINO;Vereador;Masculino;121;11;0;110
OURO FINO;Vereador;Feminino;57;0;0;57
OURO PRETO;Vereador;Masculino;171;13;0;158
OURO PRETO;Vereador;Feminino;80;2;0;78
OURO PRETO DO OESTE;Vereador;Masculino;70;6;0;64
OURO PRETO DO OESTE;Vereador;Feminino;31;3;0;28
OURO VELHO;Vereador;Masculino;20;8;0;12
OURO VELHO;Vereador;Feminino;10;1;0;9
OURO VERDE;Vereador;Masculino;53;16;0;37
OURO VERDE;Vereador;Feminino;26;2;0;24
OURO VERDE DE GOIÁS;Vereador;Masculino;42;7;0;35
OURO VERDE DE GOIÁS;Vereador;Feminino;20;2;0;18
OURO VERDE DE MINAS;Vereador;Masculino;37;8;0;29
OURO VERDE DE MINAS;Vereador;Feminino;19;1;0;18
OURO VERDE DO OESTE;Vereador;Masculino;21;7;0;14
OURO VERDE DO OESTE;Vereador;Feminino;12;2;0;10
OUROESTE;Vereador;Masculino;19;7;0;12
OUROESTE;Vereador;Feminino;11;2;0;9
OUROLÂNDIA;Vereador;Masculino;25;9;0;16
OUROLÂNDIA;Vereador;Feminino;12;2;0;10
OUVIDOR;Vereador;Masculino;25;8;0;17
OUVIDOR;Vereador;Feminino;14;1;0;13
PACAEMBU;Vereador;Masculino;40;7;0;33
PACAEMBU;Vereador;Feminino;20;2;0;18
PACAJÁ;Vereador;Masculino;65;11;0;54
PACAJÁ;Vereador;Feminino;30;0;0;30
PACAJUS;Vereador;Masculino;96;13;0;83
PACAJUS;Vereador;Feminino;42;2;0;40
PACARAIMA;Vereador;Masculino;60;8;0;52
PACARAIMA;Vereador;Feminino;34;1;0;33
PACATUBA;Vereador;Masculino;155;21;0;134
PACATUBA;Vereador;Feminino;76;3;0;73
PAÇO DO LUMIAR;Vereador;Masculino;133;12;0;121
PAÇO DO LUMIAR;Vereador;Feminino;60;3;0;57
PACOTI;Vereador;Masculino;42;8;0;34
PACOTI;Vereador;Feminino;20;1;0;19
PACUJÁ;Vereador;Masculino;20;8;0;12
PACUJÁ;Vereador;Feminino;10;1;0;9
PADRE BERNARDO;Vereador;Masculino;104;10;0;94
PADRE BERNARDO;Vereador;Feminino;50;1;0;49
PADRE CARVALHO;Vereador;Masculino;31;9;0;22
PADRE CARVALHO;Vereador;Feminino;17;0;0;17
PADRE MARCOS;Vereador;Masculino;14;7;0;7
PADRE MARCOS;Vereador;Feminino;6;2;0;4
PADRE PARAÍSO;Vereador;Masculino;59;11;0;48
PADRE PARAÍSO;Vereador;Feminino;28;0;0;28
PAES LANDIM;Vereador;Masculino;20;6;0;14
PAES LANDIM;Vereador;Feminino;9;3;0;6
PAI PEDRO;Vereador;Masculino;26;8;0;18
PAI PEDRO;Vereador;Feminino;13;1;0;12
PAIAL;Vereador;Masculino;19;9;0;10
PAIAL;Vereador;Feminino;9;0;0;9
PAIÇANDU;Vereador;Masculino;102;9;0;93
PAIÇANDU;Vereador;Feminino;53;0;0;53
PAIM FILHO;Vereador;Masculino;16;9;0;7
PAIM FILHO;Vereador;Feminino;7;0;0;7
PAINEIRAS;Vereador;Masculino;30;9;0;21
PAINEIRAS;Vereador;Feminino;15;0;0;15
PAINEL;Vereador;Masculino;30;8;0;22
PAINEL;Vereador;Feminino;14;1;0;13
PAINS;Vereador;Masculino;42;9;0;33
PAINS;Vereador;Feminino;22;0;0;22
PAIVA;Vereador;Masculino;21;8;0;13
PAIVA;Vereador;Feminino;11;1;0;10
PAJEÚ DO PIAUÍ;Vereador;Masculino;12;9;0;3
PAJEÚ DO PIAUÍ;Vereador;Feminino;6;0;0;6
PALESTINA;Vereador;Masculino;71;17;0;54
PALESTINA;Vereador;Feminino;34;1;0;33
PALESTINA DE GOIÁS;Vereador;Masculino;32;8;0;24
PALESTINA DE GOIÁS;Vereador;Feminino;17;1;0;16
PALESTINA DO PARÁ;Vereador;Masculino;22;7;0;15
PALESTINA DO PARÁ;Vereador;Feminino;15;2;0;13
PALHANO;Vereador;Masculino;26;7;0;19
PALHANO;Vereador;Feminino;13;2;0;11
PALHOÇA;Vereador;Masculino;93;10;0;83
PALHOÇA;Vereador;Feminino;40;1;0;39
PALMA;Vereador;Masculino;33;8;0;25
PALMA;Vereador;Feminino;17;1;0;16
PALMA SOLA;Vereador;Masculino;32;8;0;24
PALMA SOLA;Vereador;Feminino;16;1;0;15
PALMÁCIA;Vereador;Masculino;48;9;0;39
PALMÁCIA;Vereador;Feminino;20;0;0;20
PALMARES;Vereador;Masculino;134;13;0;121
PALMARES;Vereador;Feminino;53;2;0;51
PALMARES DO SUL;Vereador;Masculino;41;7;0;34
PALMARES DO SUL;Vereador;Feminino;20;2;0;18
PALMARES PAULISTA;Vereador;Masculino;37;5;0;32
PALMARES PAULISTA;Vereador;Feminino;22;4;0;18
PALMAS;Vereador;Masculino;260;30;0;230
PALMAS;Vereador;Feminino;115;2;0;113
PALMAS DE MONTE ALTO;Vereador;Masculino;31;9;0;22
PALMAS DE MONTE ALTO;Vereador;Feminino;16;2;0;14
PALMEIRA;Vereador;Masculino;88;17;0;71
PALMEIRA;Vereador;Feminino;44;1;0;43
PALMEIRA DAS MISSÕES;Vereador;Masculino;30;10;0;20
PALMEIRA DAS MISSÕES;Vereador;Feminino;11;1;0;10
PALMEIRA DO PIAUÍ;Vereador;Masculino;21;9;0;12
PALMEIRA DO PIAUÍ;Vereador;Feminino;10;0;0;10
PALMEIRA D'OESTE;Vereador;Masculino;24;6;0;18
PALMEIRA D'OESTE;Vereador;Feminino;12;3;0;9
PALMEIRA DOS ÍNDIOS;Vereador;Masculino;106;13;0;93
PALMEIRA DOS ÍNDIOS;Vereador;Feminino;46;2;0;44
PALMEIRAIS;Vereador;Masculino;41;9;0;32
PALMEIRAIS;Vereador;Feminino;23;0;0;23
PALMEIRÂNDIA;Vereador;Masculino;85;8;0;77
PALMEIRÂNDIA;Vereador;Feminino;36;3;0;33
PALMEIRANTE;Vereador;Masculino;19;9;0;10
PALMEIRANTE;Vereador;Feminino;9;0;0;9
PALMEIRAS;Vereador;Masculino;25;8;0;17
PALMEIRAS;Vereador;Feminino;13;1;0;12
PALMEIRAS DE GOIÁS;Vereador;Masculino;59;10;0;49
PALMEIRAS DE GOIÁS;Vereador;Feminino;28;1;0;27
PALMEIRAS DO TOCANTINS;Vereador;Masculino;34;8;0;26
PALMEIRAS DO TOCANTINS;Vereador;Feminino;19;1;0;18
PALMEIRINA;Vereador;Masculino;27;8;0;19
PALMEIRINA;Vereador;Feminino;11;1;0;10
PALMEIRÓPOLIS;Vereador;Masculino;19;8;0;11
PALMEIRÓPOLIS;Vereador;Feminino;9;1;0;8
PALMELO;Vereador;Masculino;23;7;0;16
PALMELO;Vereador;Feminino;10;2;0;8
PALMINÓPOLIS;Vereador;Masculino;19;7;0;12
PALMINÓPOLIS;Vereador;Feminino;7;2;0;5
PALMITAL;Vereador;Masculino;69;18;0;51
PALMITAL;Vereador;Feminino;35;2;0;33
PALMITINHO;Vereador;Masculino;22;7;0;15
PALMITINHO;Vereador;Feminino;11;2;0;9
PALMITOS;Vereador;Masculino;23;9;0;14
PALMITOS;Vereador;Feminino;13;2;0;11
PALMÓPOLIS;Vereador;Masculino;26;7;0;19
PALMÓPOLIS;Vereador;Feminino;14;2;0;12
PALOTINA;Vereador;Masculino;35;9;0;26
PALOTINA;Vereador;Feminino;16;0;0;16
PANAMÁ;Vereador;Masculino;26;6;0;20
PANAMÁ;Vereador;Feminino;12;3;0;9
PANAMBI;Vereador;Masculino;46;11;0;35
PANAMBI;Vereador;Feminino;23;2;0;21
PANCAS;Vereador;Masculino;86;10;0;76
PANCAS;Vereador;Feminino;42;1;0;41
PANELAS;Vereador;Masculino;27;9;0;18
PANELAS;Vereador;Feminino;14;2;0;12
PANORAMA;Vereador;Masculino;69;7;0;62
PANORAMA;Vereador;Feminino;36;2;0;34
PANTANO GRANDE;Vereador;Masculino;27;7;0;20
PANTANO GRANDE;Vereador;Feminino;16;2;0;14
PÃO DE AÇÚCAR;Vereador;Masculino;43;7;0;36
PÃO DE AÇÚCAR;Vereador;Feminino;20;4;0;16
PAPAGAIOS;Vereador;Masculino;36;8;0;28
PAPAGAIOS;Vereador;Feminino;18;1;0;17
PAPANDUVA;Vereador;Masculino;53;7;0;46
PAPANDUVA;Vereador;Feminino;28;2;0;26
PAQUETÁ;Vereador;Masculino;21;8;0;13
PAQUETÁ;Vereador;Feminino;10;1;0;9
PARÁ DE MINAS;Vereador;Masculino;180;16;0;164
PARÁ DE MINAS;Vereador;Feminino;93;1;0;92
PARACAMBI;Vereador;Masculino;72;8;0;64
PARACAMBI;Vereador;Feminino;35;1;0;34
PARACATU;Vereador;Masculino;127;15;0;112
PARACATU;Vereador;Feminino;58;2;0;56
PARACURU;Vereador;Masculino;84;11;0;73
PARACURU;Vereador;Feminino;39;2;0;37
PARAGOMINAS;Vereador;Masculino;100;10;0;90
PARAGOMINAS;Vereador;Feminino;45;3;0;42
PARAGUAÇU;Vereador;Masculino;56;9;0;47
PARAGUAÇU;Vereador;Feminino;28;0;0;28
PARAGUAÇU PAULISTA;Vereador;Masculino;82;9;0;73
PARAGUAÇU PAULISTA;Vereador;Feminino;37;4;0;33
PARAÍ;Vereador;Masculino;18;7;0;11
PARAÍ;Vereador;Feminino;8;2;0;6
PARAÍBA DO SUL;Vereador;Masculino;115;10;0;105
PARAÍBA DO SUL;Vereador;Feminino;51;1;0;50
PARAIBANO;Vereador;Masculino;26;6;0;20
PARAIBANO;Vereador;Feminino;18;5;0;13
PARAIBUNA;Vereador;Masculino;48;10;0;38
PARAIBUNA;Vereador;Feminino;22;1;0;21
PARAIPABA;Vereador;Masculino;58;12;0;46
PARAIPABA;Vereador;Feminino;26;1;0;25
PARAÍSO;Vereador;Masculino;41;14;0;27
PARAÍSO;Vereador;Feminino;21;4;0;17
PARAÍSO DAS ÁGUAS;Vereador;Masculino;29;9;0;20
PARAÍSO DAS ÁGUAS;Vereador;Feminino;15;0;0;15
PARAÍSO DO NORTE;Vereador;Masculino;21;7;0;14
PARAÍSO DO NORTE;Vereador;Feminino;11;2;0;9
PARAÍSO DO SUL;Vereador;Masculino;30;7;0;23
PARAÍSO DO SUL;Vereador;Feminino;15;2;0;13
PARAÍSO DO TOCANTINS;Vereador;Masculino;68;7;0;61
PARAÍSO DO TOCANTINS;Vereador;Feminino;36;2;0;34
PARAISÓPOLIS;Vereador;Masculino;55;8;0;47
PARAISÓPOLIS;Vereador;Feminino;27;1;0;26
PARAMBU;Vereador;Masculino;23;13;0;10
PARAMBU;Vereador;Feminino;11;0;0;11
PARAMIRIM;Vereador;Masculino;23;11;0;12
PARAMIRIM;Vereador;Feminino;10;0;0;10
PARAMOTI;Vereador;Masculino;31;7;0;24
PARAMOTI;Vereador;Feminino;15;2;0;13
PARANÁ;Vereador;Masculino;19;8;0;11
PARANÁ;Vereador;Feminino;10;1;0;9
PARANÃ;Vereador;Masculino;47;9;0;38
PARANÃ;Vereador;Feminino;23;0;0;23
PARANACITY;Vereador;Masculino;50;7;0;43
PARANACITY;Vereador;Feminino;25;2;0;23
PARANAGUÁ;Vereador;Masculino;199;14;0;185
PARANAGUÁ;Vereador;Feminino;82;3;0;79
PARANAÍBA;Vereador;Masculino;44;7;0;37
PARANAÍBA;Vereador;Feminino;23;2;0;21
PARANAIGUARA;Vereador;Masculino;35;7;0;28
PARANAIGUARA;Vereador;Feminino;23;2;0;21
PARANAÍTA;Vereador;Masculino;23;7;0;16
PARANAÍTA;Vereador;Feminino;12;2;0;10
PARANAPANEMA;Vereador;Masculino;32;9;0;23
PARANAPANEMA;Vereador;Feminino;16;0;0;16
PARANAPOEMA;Vereador;Masculino;26;9;0;17
PARANAPOEMA;Vereador;Feminino;7;0;0;7
PARANAPUÃ;Vereador;Masculino;16;6;0;10
PARANAPUÃ;Vereador;Feminino;9;3;0;6
PARANATAMA;Vereador;Masculino;34;7;0;27
PARANATAMA;Vereador;Feminino;14;2;0;12
PARANATINGA;Vereador;Masculino;50;10;0;40
PARANATINGA;Vereador;Feminino;19;1;0;18
PARANAVAÍ;Vereador;Masculino;84;9;0;75
PARANAVAÍ;Vereador;Feminino;38;1;0;37
PARANHOS;Vereador;Masculino;35;7;0;28
PARANHOS;Vereador;Feminino;18;2;0;16
PARAOPEBA;Vereador;Masculino;113;11;0;102
PARAOPEBA;Vereador;Feminino;57;0;0;57
PARAPUÃ;Vereador;Masculino;48;9;0;39
PARAPUÃ;Vereador;Feminino;27;0;0;27
PARARI;Vereador;Masculino;16;7;0;9
PARARI;Vereador;Feminino;9;2;0;7
PARATINGA;Vereador;Masculino;45;11;0;34
PARATINGA;Vereador;Feminino;21;0;0;21
PARATY;Vereador;Masculino;90;9;0;81
PARATY;Vereador;Feminino;47;0;0;47
PARAÚ;Vereador;Masculino;18;4;0;14
PARAÚ;Vereador;Feminino;8;5;0;3
PARAUAPEBAS;Vereador;Masculino;157;13;0;144
PARAUAPEBAS;Vereador;Feminino;71;2;0;69
PARAÚNA;Vereador;Masculino;43;8;0;35
PARAÚNA;Vereador;Feminino;20;1;0;19
PARAZINHO;Vereador;Masculino;18;7;0;11
PARAZINHO;Vereador;Feminino;10;2;0;8
PARDINHO;Vereador;Masculino;23;8;0;15
PARDINHO;Vereador;Feminino;11;1;0;10
PARECI NOVO;Vereador;Masculino;28;8;0;20
PARECI NOVO;Vereador;Feminino;15;1;0;14
PARECIS;Vereador;Masculino;27;9;0;18
PARECIS;Vereador;Feminino;16;0;0;16
PARELHAS;Vereador;Masculino;30;8;0;22
PARELHAS;Vereador;Feminino;15;3;0;12
PARICONHA;Vereador;Masculino;26;6;0;20
PARICONHA;Vereador;Feminino;16;3;0;13
PARINTINS;Vereador;Masculino;93;9;0;84
PARINTINS;Vereador;Feminino;44;2;0;42
PARIPIRANGA;Vereador;Masculino;29;10;0;19
PARIPIRANGA;Vereador;Feminino;14;1;0;13
PARIPUEIRA;Vereador;Masculino;20;9;0;11
PARIPUEIRA;Vereador;Feminino;9;0;0;9
PARIQUERA-AÇU;Vereador;Masculino;91;9;0;82
PARIQUERA-AÇU;Vereador;Feminino;47;0;0;47
PARISI;Vereador;Masculino;27;8;0;19
PARISI;Vereador;Feminino;11;1;0;10
PARNAGUÁ;Vereador;Masculino;18;5;0;13
PARNAGUÁ;Vereador;Feminino;9;4;0;5
PARNAÍBA;Vereador;Masculino;177;15;0;162
PARNAÍBA;Vereador;Feminino;80;2;0;78
PARNAMIRIM;Vereador;Masculino;186;26;0;160
PARNAMIRIM;Vereador;Feminino;79;3;0;76
PARNARAMA;Vereador;Masculino;46;11;0;35
PARNARAMA;Vereador;Feminino;21;2;0;19
PAROBÉ;Vereador;Masculino;108;12;0;96
PAROBÉ;Vereador;Feminino;53;3;0;50
PASSA E FICA;Vereador;Masculino;13;8;0;5
PASSA E FICA;Vereador;Feminino;5;1;0;4
PASSA QUATRO;Vereador;Masculino;42;7;0;35
PASSA QUATRO;Vereador;Feminino;20;2;0;18
PASSA SETE;Vereador;Masculino;24;8;0;16
PASSA SETE;Vereador;Feminino;12;1;0;11
PASSA TEMPO;Vereador;Masculino;50;7;0;43
PASSA TEMPO;Vereador;Feminino;25;2;0;23
PASSA VINTE;Vereador;Masculino;43;9;0;34
PASSA VINTE;Vereador;Feminino;20;0;0;20
PASSABÉM;Vereador;Masculino;21;8;0;13
PASSABÉM;Vereador;Feminino;11;1;0;10
PASSAGEM;Vereador;Masculino;32;13;0;19
PASSAGEM;Vereador;Feminino;16;5;0;11
PASSAGEM FRANCA;Vereador;Masculino;22;10;0;12
PASSAGEM FRANCA;Vereador;Feminino;12;1;0;11
PASSAGEM FRANCA DO PIAUÍ;Vereador;Masculino;13;5;0;8
PASSAGEM FRANCA DO PIAUÍ;Vereador;Feminino;12;4;0;8
PASSIRA;Vereador;Masculino;40;9;0;31
PASSIRA;Vereador;Feminino;21;2;0;19
PASSO DE CAMARAGIBE;Vereador;Masculino;52;7;0;45
PASSO DE CAMARAGIBE;Vereador;Feminino;27;2;0;25
PASSO DE TORRES;Vereador;Masculino;24;8;0;16
PASSO DE TORRES;Vereador;Feminino;12;1;0;11
PASSO DO SOBRADO;Vereador;Masculino;29;7;0;22
PASSO DO SOBRADO;Vereador;Feminino;13;2;0;11
PASSO FUNDO;Vereador;Masculino;161;20;0;141
PASSO FUNDO;Vereador;Feminino;80;1;0;79
PASSOS;Vereador;Masculino;110;9;0;101
PASSOS;Vereador;Feminino;54;2;0;52
PASSOS MAIA;Vereador;Masculino;21;5;0;16
PASSOS MAIA;Vereador;Feminino;10;4;0;6
PASTOS BONS;Vereador;Masculino;27;9;0;18
PASTOS BONS;Vereador;Feminino;13;2;0;11
PATIS;Vereador;Masculino;24;9;0;15
PATIS;Vereador;Feminino;12;0;0;12
PATO BRAGADO;Vereador;Masculino;24;8;0;16
PATO BRAGADO;Vereador;Feminino;12;1;0;11
PATO BRANCO;Vereador;Masculino;61;10;0;51
PATO BRANCO;Vereador;Feminino;23;1;0;22
PATOS;Vereador;Masculino;114;9;0;105
PATOS;Vereador;Feminino;52;4;0;48
PATOS DE MINAS;Vereador;Masculino;121;16;0;105
PATOS DE MINAS;Vereador;Feminino;50;1;0;49
PATOS DO PIAUÍ;Vereador;Masculino;18;9;0;9
PATOS DO PIAUÍ;Vereador;Feminino;8;0;0;8
PATROCÍNIO;Vereador;Masculino;126;10;0;116
PATROCÍNIO;Vereador;Feminino;56;5;0;51
PATROCÍNIO DO MURIAÉ;Vereador;Masculino;34;8;0;26
PATROCÍNIO DO MURIAÉ;Vereador;Feminino;19;1;0;18
PATROCÍNIO PAULISTA;Vereador;Masculino;51;8;0;43
PATROCÍNIO PAULISTA;Vereador;Feminino;25;1;0;24
PATU;Vereador;Masculino;24;7;0;17
PATU;Vereador;Feminino;12;2;0;10
PATY DO ALFERES;Vereador;Masculino;103;11;0;92
PATY DO ALFERES;Vereador;Feminino;49;0;0;49
PAU BRASIL;Vereador;Masculino;23;9;0;14
PAU BRASIL;Vereador;Feminino;10;0;0;10
PAU D'ARCO;Vereador;Masculino;68;16;0;52
PAU D'ARCO;Vereador;Feminino;37;2;0;35
PAU D'ARCO DO PIAUÍ;Vereador;Masculino;35;9;0;26
PAU D'ARCO DO PIAUÍ;Vereador;Feminino;17;0;0;17
PAU DOS FERROS;Vereador;Masculino;23;6;0;17
PAU DOS FERROS;Vereador;Feminino;12;3;0;9
PAUDALHO;Vereador;Masculino;106;11;0;95
PAUDALHO;Vereador;Feminino;37;2;0;35
PAUINI;Vereador;Masculino;24;10;0;14
PAUINI;Vereador;Feminino;12;1;0;11
PAULA CÂNDIDO;Vereador;Masculino;42;9;0;33
PAULA CÂNDIDO;Vereador;Feminino;20;0;0;20
PAULA FREITAS;Vereador;Masculino;38;8;0;30
PAULA FREITAS;Vereador;Feminino;7;1;0;6
PAULICÉIA;Vereador;Masculino;36;9;0;27
PAULICÉIA;Vereador;Feminino;17;0;0;17
PAULÍNIA;Vereador;Masculino;165;13;0;152
PAULÍNIA;Vereador;Feminino;88;2;0;86
PAULINO NEVES;Vereador;Masculino;27;7;0;20
PAULINO NEVES;Vereador;Feminino;13;2;0;11
PAULISTA;Vereador;Masculino;257;20;0;237
PAULISTA;Vereador;Feminino;104;4;0;100
PAULISTANA;Vereador;Masculino;22;9;0;13
PAULISTANA;Vereador;Feminino;11;2;0;9
PAULISTÂNIA;Vereador;Masculino;30;6;0;24
PAULISTÂNIA;Vereador;Feminino;11;3;0;8
PAULISTAS;Vereador;Masculino;34;6;0;28
PAULISTAS;Vereador;Feminino;17;3;0;14
PAULO AFONSO;Vereador;Masculino;101;15;0;86
PAULO AFONSO;Vereador;Feminino;38;0;0;38
PAULO BENTO;Vereador;Masculino;24;9;0;15
PAULO BENTO;Vereador;Feminino;12;0;0;12
PAULO DE FARIA;Vereador;Masculino;43;7;0;36
PAULO DE FARIA;Vereador;Feminino;18;2;0;16
PAULO FRONTIN;Vereador;Masculino;50;8;0;42
PAULO FRONTIN;Vereador;Feminino;25;1;0;24
PAULO JACINTO;Vereador;Masculino;43;7;0;36
PAULO JACINTO;Vereador;Feminino;23;2;0;21
PAULO LOPES;Vereador;Masculino;21;7;0;14
PAULO LOPES;Vereador;Feminino;11;2;0;9
PAULO RAMOS;Vereador;Masculino;29;9;0;20
PAULO RAMOS;Vereador;Feminino;14;2;0;12
PAVÃO;Vereador;Masculino;37;7;0;30
PAVÃO;Vereador;Feminino;21;2;0;19
PAVERAMA;Vereador;Masculino;31;9;0;22
PAVERAMA;Vereador;Feminino;17;0;0;17
PAVUSSU;Vereador;Masculino;19;6;0;13
PAVUSSU;Vereador;Feminino;10;3;0;7
PÉ DE SERRA;Vereador;Masculino;30;9;0;21
PÉ DE SERRA;Vereador;Feminino;15;0;0;15
PEABIRU;Vereador;Masculino;44;9;0;35
PEABIRU;Vereador;Feminino;21;0;0;21
PEÇANHA;Vereador;Masculino;73;11;0;62
PEÇANHA;Vereador;Feminino;37;0;0;37
PEDERNEIRAS;Vereador;Masculino;115;8;0;107
PEDERNEIRAS;Vereador;Feminino;61;1;0;60
PEDRA;Vereador;Masculino;21;11;0;10
PEDRA;Vereador;Feminino;9;0;0;9
PEDRA AZUL;Vereador;Masculino;64;11;0;53
PEDRA AZUL;Vereador;Feminino;33;0;0;33
PEDRA BELA;Vereador;Masculino;31;8;0;23
PEDRA BELA;Vereador;Feminino;16;1;0;15
PEDRA BONITA;Vereador;Masculino;23;9;0;14
PEDRA BONITA;Vereador;Feminino;13;0;0;13
PEDRA BRANCA;Vereador;Masculino;40;15;0;25
PEDRA BRANCA;Vereador;Feminino;21;3;0;18
PEDRA BRANCA DO AMAPARI;Vereador;Masculino;54;8;0;46
PEDRA BRANCA DO AMAPARI;Vereador;Feminino;23;1;0;22
PEDRA DO ANTA;Vereador;Masculino;26;8;0;18
PEDRA DO ANTA;Vereador;Feminino;12;1;0;11
PEDRA DO INDAIÁ;Vereador;Masculino;37;8;0;29
PEDRA DO INDAIÁ;Vereador;Feminino;19;1;0;18
PEDRA DOURADA;Vereador;Masculino;15;7;0;8
PEDRA DOURADA;Vereador;Feminino;8;2;0;6
PEDRA GRANDE;Vereador;Masculino;22;8;0;14
PEDRA GRANDE;Vereador;Feminino;9;1;0;8
PEDRA LAVRADA;Vereador;Masculino;26;8;0;18
PEDRA LAVRADA;Vereador;Feminino;13;1;0;12
PEDRA MOLE;Vereador;Masculino;18;8;0;10
PEDRA MOLE;Vereador;Feminino;9;1;0;8
PEDRA PRETA;Vereador;Masculino;76;15;0;61
PEDRA PRETA;Vereador;Feminino;36;5;0;31
PEDRALVA;Vereador;Masculino;63;8;0;55
PEDRALVA;Vereador;Feminino;33;1;0;32
PEDRANÓPOLIS;Vereador;Masculino;22;7;0;15
PEDRANÓPOLIS;Vereador;Feminino;11;2;0;9
PEDRÃO;Vereador;Masculino;51;9;0;42
PEDRÃO;Vereador;Feminino;25;0;0;25
PEDRAS ALTAS;Vereador;Masculino;23;8;0;15
PEDRAS ALTAS;Vereador;Feminino;11;1;0;10
PEDRAS DE FOGO;Vereador;Masculino;75;8;0;67
PEDRAS DE FOGO;Vereador;Feminino;35;3;0;32
PEDRAS DE MARIA DA CRUZ;Vereador;Masculino;66;9;0;57
PEDRAS DE MARIA DA CRUZ;Vereador;Feminino;31;0;0;31
PEDRAS GRANDES;Vereador;Masculino;21;8;0;13
PEDRAS GRANDES;Vereador;Feminino;10;1;0;9
PEDREGULHO;Vereador;Masculino;73;10;0;63
PEDREGULHO;Vereador;Feminino;36;1;0;35
PEDREIRA;Vereador;Masculino;83;9;0;74
PEDREIRA;Vereador;Feminino;43;0;0;43
PEDREIRAS;Vereador;Masculino;59;12;0;47
PEDREIRAS;Vereador;Feminino;25;1;0;24
PEDRINHAS;Vereador;Masculino;40;9;0;31
PEDRINHAS;Vereador;Feminino;20;0;0;20
PEDRINHAS PAULISTA;Vereador;Masculino;29;8;0;21
PEDRINHAS PAULISTA;Vereador;Feminino;14;1;0;13
PEDRINÓPOLIS;Vereador;Masculino;28;8;0;20
PEDRINÓPOLIS;Vereador;Feminino;12;1;0;11
PEDRO AFONSO;Vereador;Masculino;48;6;0;42
PEDRO AFONSO;Vereador;Feminino;26;3;0;23
PEDRO ALEXANDRE;Vereador;Masculino;29;11;0;18
PEDRO ALEXANDRE;Vereador;Feminino;12;0;0;12
PEDRO AVELINO;Vereador;Masculino;31;9;0;22
PEDRO AVELINO;Vereador;Feminino;15;0;0;15
PEDRO CANÁRIO;Vereador;Masculino;54;11;0;43
PEDRO CANÁRIO;Vereador;Feminino;25;0;0;25
PEDRO DE TOLEDO;Vereador;Masculino;89;7;0;82
PEDRO DE TOLEDO;Vereador;Feminino;44;2;0;42
PEDRO DO ROSÁRIO;Vereador;Masculino;51;9;0;42
PEDRO DO ROSÁRIO;Vereador;Feminino;28;2;0;26
PEDRO GOMES;Vereador;Masculino;33;9;0;24
PEDRO GOMES;Vereador;Feminino;16;0;0;16
PEDRO II;Vereador;Masculino;38;12;0;26
PEDRO II;Vereador;Feminino;17;1;0;16
PEDRO LAURENTINO;Vereador;Masculino;22;8;0;14
PEDRO LAURENTINO;Vereador;Feminino;11;1;0;10
PEDRO LEOPOLDO;Vereador;Masculino;95;10;0;85
PEDRO LEOPOLDO;Vereador;Feminino;42;0;0;42
PEDRO OSÓRIO;Vereador;Masculino;28;8;0;20
PEDRO OSÓRIO;Vereador;Feminino;16;1;0;15
PEDRO RÉGIS;Vereador;Masculino;26;9;0;17
PEDRO RÉGIS;Vereador;Feminino;15;0;0;15
PEDRO TEIXEIRA;Vereador;Masculino;21;7;0;14
PEDRO TEIXEIRA;Vereador;Feminino;10;2;0;8
PEDRO VELHO;Vereador;Masculino;32;7;0;25
PEDRO VELHO;Vereador;Feminino;17;2;0;15
PEIXE;Vereador;Masculino;43;6;0;37
PEIXE;Vereador;Feminino;20;3;0;17
PEIXE-BOI;Vereador;Masculino;54;8;0;46
PEIXE-BOI;Vereador;Feminino;27;1;0;26
PEIXOTO DE AZEVEDO;Vereador;Masculino;62;10;0;52
PEIXOTO DE AZEVEDO;Vereador;Feminino;26;1;0;25
PEJUÇARA;Vereador;Masculino;18;7;0;11
PEJUÇARA;Vereador;Feminino;12;2;0;10
PELOTAS;Vereador;Masculino;242;21;0;221
PELOTAS;Vereador;Feminino;105;0;0;105
PENAFORTE;Vereador;Masculino;17;7;0;10
PENAFORTE;Vereador;Feminino;7;2;0;5
PENALVA;Vereador;Masculino;47;11;0;36
PENALVA;Vereador;Feminino;20;2;0;18
PENÁPOLIS;Vereador;Masculino;116;13;0;103
PENÁPOLIS;Vereador;Feminino;52;0;0;52
PENDÊNCIAS;Vereador;Masculino;35;8;0;27
PENDÊNCIAS;Vereador;Feminino;16;1;0;15
PENEDO;Vereador;Masculino;89;12;0;77
PENEDO;Vereador;Feminino;42;1;0;41
PENHA;Vereador;Masculino;57;9;0;48
PENHA;Vereador;Feminino;28;2;0;26
PENTECOSTE;Vereador;Masculino;71;12;0;59
PENTECOSTE;Vereador;Feminino;35;1;0;34
PEQUERI;Vereador;Masculino;36;9;0;27
PEQUERI;Vereador;Feminino;19;0;0;19
PEQUI;Vereador;Masculino;39;9;0;30
PEQUI;Vereador;Feminino;21;0;0;21
PEQUIZEIRO;Vereador;Masculino;27;8;0;19
PEQUIZEIRO;Vereador;Feminino;15;1;0;14
PERDIGÃO;Vereador;Masculino;36;7;0;29
PERDIGÃO;Vereador;Feminino;20;2;0;18
PERDIZES;Vereador;Masculino;31;8;0;23
PERDIZES;Vereador;Feminino;17;1;0;16
PERDÕES;Vereador;Masculino;57;8;0;49
PERDÕES;Vereador;Feminino;30;1;0;29
PEREIRA BARRETO;Vereador;Masculino;60;10;0;50
PEREIRA BARRETO;Vereador;Feminino;30;1;0;29
PEREIRAS;Vereador;Masculino;30;9;0;21
PEREIRAS;Vereador;Feminino;15;0;0;15
PEREIRO;Vereador;Masculino;32;7;0;25
PEREIRO;Vereador;Feminino;16;4;0;12
PERI MIRIM;Vereador;Masculino;46;7;0;39
PERI MIRIM;Vereador;Feminino;22;2;0;20
PERIQUITO;Vereador;Masculino;45;9;0;36
PERIQUITO;Vereador;Feminino;19;0;0;19
PERITIBA;Vereador;Masculino;19;8;0;11
PERITIBA;Vereador;Feminino;11;1;0;10
PERITORÓ;Vereador;Masculino;54;10;0;44
PERITORÓ;Vereador;Feminino;26;1;0;25
PEROBAL;Vereador;Masculino;32;9;0;23
PEROBAL;Vereador;Feminino;16;0;0;16
PÉROLA;Vereador;Masculino;35;9;0;26
PÉROLA;Vereador;Feminino;20;0;0;20
PÉROLA D'OESTE;Vereador;Masculino;23;9;0;14
PÉROLA D'OESTE;Vereador;Feminino;10;0;0;10
PEROLÂNDIA;Vereador;Masculino;33;7;0;26
PEROLÂNDIA;Vereador;Feminino;16;2;0;14
PERUÍBE;Vereador;Masculino;185;14;0;171
PERUÍBE;Vereador;Feminino;74;1;0;73
PESCADOR;Vereador;Masculino;39;8;0;31
PESCADOR;Vereador;Feminino;18;1;0;17
PESCARIA BRAVA;Vereador;Masculino;35;7;0;28
PESCARIA BRAVA;Vereador;Feminino;18;2;0;16
PESQUEIRA;Vereador;Masculino;95;15;0;80
PESQUEIRA;Vereador;Feminino;40;0;0;40
PETROLÂNDIA;Vereador;Masculino;73;16;0;57
PETROLÂNDIA;Vereador;Feminino;34;4;0;30
PETROLINA;Vereador;Masculino;156;17;0;139
PETROLINA;Vereador;Feminino;58;2;0;56
PETROLINA DE GOIÁS;Vereador;Masculino;33;8;0;25
PETROLINA DE GOIÁS;Vereador;Feminino;16;1;0;15
PETRÓPOLIS;Vereador;Masculino;229;14;0;215
PETRÓPOLIS;Vereador;Feminino;104;1;0;103
PIAÇABUÇU;Vereador;Masculino;38;9;0;29
PIAÇABUÇU;Vereador;Feminino;19;2;0;17
PIACATU;Vereador;Masculino;29;9;0;20
PIACATU;Vereador;Feminino;14;0;0;14
PIANCÓ;Vereador;Masculino;30;7;0;23
PIANCÓ;Vereador;Feminino;15;4;0;11
PIATÃ;Vereador;Masculino;25;11;0;14
PIATÃ;Vereador;Feminino;11;0;0;11
PIAU;Vereador;Masculino;26;9;0;17
PIAU;Vereador;Feminino;14;0;0;14
PICADA CAFÉ;Vereador;Masculino;33;9;0;24
PICADA CAFÉ;Vereador;Feminino;16;0;0;16
PIÇARRA;Vereador;Masculino;24;9;0;15
PIÇARRA;Vereador;Feminino;12;0;0;12
PICOS;Vereador;Masculino;84;14;0;70
PICOS;Vereador;Feminino;42;1;0;41
PICUÍ;Vereador;Masculino;25;8;0;17
PICUÍ;Vereador;Feminino;11;3;0;8
PIEDADE;Vereador;Masculino;94;12;0;82
PIEDADE;Vereador;Feminino;43;1;0;42
PIEDADE DE CARATINGA;Vereador;Masculino;43;7;0;36
PIEDADE DE CARATINGA;Vereador;Feminino;20;2;0;18
PIEDADE DE PONTE NOVA;Vereador;Masculino;70;7;0;63
PIEDADE DE PONTE NOVA;Vereador;Feminino;35;2;0;33
PIEDADE DO RIO GRANDE;Vereador;Masculino;35;8;0;27
PIEDADE DO RIO GRANDE;Vereador;Feminino;17;1;0;16
PIEDADE DOS GERAIS;Vereador;Masculino;27;8;0;19
PIEDADE DOS GERAIS;Vereador;Feminino;13;1;0;12
PIÊN;Vereador;Masculino;61;8;0;53
PIÊN;Vereador;Feminino;28;1;0;27
PILÃO ARCADO;Vereador;Masculino;36;12;0;24
PILÃO ARCADO;Vereador;Feminino;15;1;0;14
PILAR;Vereador;Masculino;107;17;0;90
PILAR;Vereador;Feminino;51;1;0;50
PILAR DE GOIÁS;Vereador;Masculino;22;9;0;13
PILAR DE GOIÁS;Vereador;Feminino;11;0;0;11
PILAR DO SUL;Vereador;Masculino;47;9;0;38
PILAR DO SUL;Vereador;Feminino;23;2;0;21
PILÕES;Vereador;Masculino;38;15;0;23
PILÕES;Vereador;Feminino;17;3;0;14
PILÕEZINHOS;Vereador;Masculino;22;7;0;15
PILÕEZINHOS;Vereador;Feminino;11;2;0;9
PIMENTA;Vereador;Masculino;43;9;0;34
PIMENTA;Vereador;Feminino;24;0;0;24
PIMENTA BUENO;Vereador;Masculino;69;10;0;59
PIMENTA BUENO;Vereador;Feminino;29;3;0;26
PIMENTEIRAS;Vereador;Masculino;21;9;0;12
PIMENTEIRAS;Vereador;Feminino;10;0;0;10
PIMENTEIRAS DO OESTE;Vereador;Masculino;26;7;0;19
PIMENTEIRAS DO OESTE;Vereador;Feminino;13;2;0;11
PINDAÍ;Vereador;Masculino;21;8;0;13
PINDAÍ;Vereador;Feminino;11;3;0;8
PINDAMONHANGABA;Vereador;Masculino;155;11;0;144
PINDAMONHANGABA;Vereador;Feminino;68;0;0;68
PINDARÉ-MIRIM;Vereador;Masculino;62;11;0;51
PINDARÉ-MIRIM;Vereador;Feminino;28;2;0;26
PINDOBA;Vereador;Masculino;14;6;0;8
PINDOBA;Vereador;Feminino;6;3;0;3
PINDOBAÇU;Vereador;Masculino;51;9;0;42
PINDOBAÇU;Vereador;Feminino;25;2;0;23
PINDORAMA;Vereador;Masculino;37;8;0;29
PINDORAMA;Vereador;Feminino;13;1;0;12
PINDORAMA DO TOCANTINS;Vereador;Masculino;28;7;0;21
PINDORAMA DO TOCANTINS;Vereador;Feminino;12;2;0;10
PINDORETAMA;Vereador;Masculino;64;8;0;56
PINDORETAMA;Vereador;Feminino;29;3;0;26
PINGO D'ÁGUA;Vereador;Masculino;55;8;0;47
PINGO D'ÁGUA;Vereador;Feminino;27;1;0;26
PINHAIS;Vereador;Masculino;212;13;0;199
PINHAIS;Vereador;Feminino;101;4;0;97
PINHAL;Vereador;Masculino;15;8;0;7
PINHAL;Vereador;Feminino;7;1;0;6
PINHAL DA SERRA;Vereador;Masculino;20;6;0;14
PINHAL DA SERRA;Vereador;Feminino;10;3;0;7
PINHAL DE SÃO BENTO;Vereador;Masculino;10;9;0;1
PINHAL DE SÃO BENTO;Vereador;Feminino;6;0;0;6
PINHAL GRANDE;Vereador;Masculino;22;9;0;13
PINHAL GRANDE;Vereador;Feminino;12;0;0;12
PINHALÃO;Vereador;Masculino;27;8;0;19
PINHALÃO;Vereador;Feminino;13;1;0;12
PINHALZINHO;Vereador;Masculino;88;15;0;73
PINHALZINHO;Vereador;Feminino;42;5;0;37
PINHÃO;Vereador;Masculino;92;21;0;71
PINHÃO;Vereador;Feminino;43;1;0;42
PINHEIRAL;Vereador;Masculino;77;8;0;69
PINHEIRAL;Vereador;Feminino;38;1;0;37
PINHEIRINHO DO VALE;Vereador;Masculino;17;7;0;10
PINHEIRINHO DO VALE;Vereador;Feminino;8;2;0;6
PINHEIRO;Vereador;Masculino;102;13;0;89
PINHEIRO;Vereador;Feminino;41;2;0;39
PINHEIRO MACHADO;Vereador;Masculino;47;9;0;38
PINHEIRO MACHADO;Vereador;Feminino;24;0;0;24
PINHEIRO PRETO;Vereador;Masculino;17;9;0;8
PINHEIRO PRETO;Vereador;Feminino;8;0;0;8
PINHEIROS;Vereador;Masculino;81;10;0;71
PINHEIROS;Vereador;Feminino;40;1;0;39
PINTADAS;Vereador;Masculino;18;8;0;10
PINTADAS;Vereador;Feminino;9;1;0;8
PINTO BANDEIRA;Vereador;Masculino;17;8;0;9
PINTO BANDEIRA;Vereador;Feminino;9;1;0;8
PINTÓPOLIS;Vereador;Masculino;41;9;0;32
PINTÓPOLIS;Vereador;Feminino;18;0;0;18
PIO IX;Vereador;Masculino;20;9;0;11
PIO IX;Vereador;Feminino;9;2;0;7
PIO XII;Vereador;Masculino;38;10;0;28
PIO XII;Vereador;Feminino;22;1;0;21
PIQUEROBI;Vereador;Masculino;30;8;0;22
PIQUEROBI;Vereador;Feminino;16;1;0;15
PIQUET CARNEIRO;Vereador;Masculino;21;10;0;11
PIQUET CARNEIRO;Vereador;Feminino;11;1;0;10
PIQUETE;Vereador;Masculino;105;7;0;98
PIQUETE;Vereador;Feminino;55;2;0;53
PIRACAIA;Vereador;Masculino;75;10;0;65
PIRACAIA;Vereador;Feminino;33;1;0;32
PIRACANJUBA;Vereador;Masculino;64;7;0;57
PIRACANJUBA;Vereador;Feminino;31;2;0;29
PIRACEMA;Vereador;Masculino;32;7;0;25
PIRACEMA;Vereador;Feminino;16;2;0;14
PIRACICABA;Vereador;Masculino;298;22;0;276
PIRACICABA;Vereador;Feminino;139;1;0;138
PIRACURUCA;Vereador;Masculino;31;10;0;21
PIRACURUCA;Vereador;Feminino;15;1;0;14
PIRAÍ;Vereador;Masculino;87;11;0;76
PIRAÍ;Vereador;Feminino;41;0;0;41
PIRAÍ DO NORTE;Vereador;Masculino;21;7;0;14
PIRAÍ DO NORTE;Vereador;Feminino;11;2;0;9
PIRAÍ DO SUL;Vereador;Masculino;52;8;0;44
PIRAÍ DO SUL;Vereador;Feminino;27;1;0;26
PIRAJU;Vereador;Masculino;77;10;0;67
PIRAJU;Vereador;Feminino;37;1;0;36
PIRAJUBA;Vereador;Masculino;22;8;0;14
PIRAJUBA;Vereador;Feminino;12;1;0;11
PIRAJUÍ;Vereador;Masculino;95;9;0;86
PIRAJUÍ;Vereador;Feminino;45;2;0;43
PIRAMBU;Vereador;Masculino;42;4;0;38
PIRAMBU;Vereador;Feminino;20;5;0;15
PIRANGA;Vereador;Masculino;48;6;0;42
PIRANGA;Vereador;Feminino;24;3;0;21
PIRANGI;Vereador;Masculino;48;5;0;43
PIRANGI;Vereador;Feminino;26;4;0;22
PIRANGUÇU;Vereador;Masculino;53;9;0;44
PIRANGUÇU;Vereador;Feminino;25;0;0;25
PIRANGUINHO;Vereador;Masculino;46;6;0;40
PIRANGUINHO;Vereador;Feminino;22;3;0;19
PIRANHAS;Vereador;Masculino;77;15;0;62
PIRANHAS;Vereador;Feminino;38;3;0;35
PIRAPEMAS;Vereador;Masculino;61;7;0;54
PIRAPEMAS;Vereador;Feminino;32;4;0;28
PIRAPETINGA;Vereador;Masculino;40;8;0;32
PIRAPETINGA;Vereador;Feminino;19;1;0;18
PIRAPÓ;Vereador;Masculino;17;8;0;9
PIRAPÓ;Vereador;Feminino;9;1;0;8
PIRAPORA;Vereador;Masculino;141;13;0;128
PIRAPORA;Vereador;Feminino;59;2;0;57
PIRAPORA DO BOM JESUS;Vereador;Masculino;123;8;0;115
PIRAPORA DO BOM JESUS;Vereador;Feminino;62;1;0;61
PIRAPOZINHO;Vereador;Masculino;76;11;0;65
PIRAPOZINHO;Vereador;Feminino;34;0;0;34
PIRAQUARA;Vereador;Masculino;116;13;0;103
PIRAQUARA;Vereador;Feminino;53;0;0;53
PIRAQUÊ;Vereador;Masculino;26;8;0;18
PIRAQUÊ;Vereador;Feminino;11;1;0;10
PIRASSUNUNGA;Vereador;Masculino;117;9;0;108
PIRASSUNUNGA;Vereador;Feminino;46;1;0;45
PIRATINI;Vereador;Masculino;36;9;0;27
PIRATINI;Vereador;Feminino;18;0;0;18
PIRATININGA;Vereador;Masculino;24;7;0;17
PIRATININGA;Vereador;Feminino;12;2;0;10
PIRATUBA;Vereador;Masculino;20;6;0;14
PIRATUBA;Vereador;Feminino;11;3;0;8
PIRAÚBA;Vereador;Masculino;31;7;0;24
PIRAÚBA;Vereador;Feminino;15;2;0;13
PIRENÓPOLIS;Vereador;Masculino;66;11;0;55
PIRENÓPOLIS;Vereador;Feminino;29;0;0;29
PIRES DO RIO;Vereador;Masculino;33;9;0;24
PIRES DO RIO;Vereador;Feminino;16;2;0;14
PIRES FERREIRA;Vereador;Masculino;22;5;0;17
PIRES FERREIRA;Vereador;Feminino;12;4;0;8
PIRIPÁ;Vereador;Masculino;31;7;0;24
PIRIPÁ;Vereador;Feminino;17;2;0;15
PIRIPIRI;Vereador;Masculino;53;11;0;42
PIRIPIRI;Vereador;Feminino;24;3;0;21
PIRITIBA;Vereador;Masculino;29;11;0;18
PIRITIBA;Vereador;Feminino;14;0;0;14
PIRPIRITUBA;Vereador;Masculino;25;7;0;18
PIRPIRITUBA;Vereador;Feminino;12;2;0;10
PITANGA;Vereador;Masculino;85;11;0;74
PITANGA;Vereador;Feminino;43;2;0;41
PITANGUEIRAS;Vereador;Masculino;73;20;0;53
PITANGUEIRAS;Vereador;Feminino;34;2;0;32
PITANGUI;Vereador;Masculino;59;8;0;51
PITANGUI;Vereador;Feminino;30;1;0;29
PITIMBU;Vereador;Masculino;61;10;0;51
PITIMBU;Vereador;Feminino;27;1;0;26
PIUM;Vereador;Masculino;24;6;0;18
PIUM;Vereador;Feminino;13;3;0;10
PIÚMA;Vereador;Masculino;82;10;0;72
PIÚMA;Vereador;Feminino;40;1;0;39
PIUMHI;Vereador;Masculino;76;7;0;69
PIUMHI;Vereador;Feminino;35;2;0;33
PLACAS;Vereador;Masculino;57;9;0;48
PLACAS;Vereador;Feminino;30;2;0;28
PLÁCIDO DE CASTRO;Vereador;Masculino;58;8;0;50
PLÁCIDO DE CASTRO;Vereador;Feminino;26;3;0;23
PLANALTINA;Vereador;Masculino;208;16;0;192
PLANALTINA;Vereador;Feminino;94;1;0;93
PLANALTINA DO PARANÁ;Vereador;Masculino;29;7;0;22
PLANALTINA DO PARANÁ;Vereador;Feminino;15;2;0;13
PLANALTINO;Vereador;Masculino;20;9;0;11
PLANALTINO;Vereador;Feminino;10;0;0;10
PLANALTO;Vereador;Masculino;121;35;0;86
PLANALTO;Vereador;Feminino;60;3;0;57
PLANALTO ALEGRE;Vereador;Masculino;24;7;0;17
PLANALTO ALEGRE;Vereador;Feminino;12;2;0;10
PLANALTO DA SERRA;Vereador;Masculino;21;7;0;14
PLANALTO DA SERRA;Vereador;Feminino;9;2;0;7
PLANURA;Vereador;Masculino;42;8;0;34
PLANURA;Vereador;Feminino;21;1;0;20
PLATINA;Vereador;Masculino;28;8;0;20
PLATINA;Vereador;Feminino;15;1;0;14
POÁ;Vereador;Masculino;230;14;0;216
POÁ;Vereador;Feminino;101;3;0;98
POÇÃO;Vereador;Masculino;32;6;0;26
POÇÃO;Vereador;Feminino;11;3;0;8
POÇÃO DE PEDRAS;Vereador;Masculino;26;9;0;17
POÇÃO DE PEDRAS;Vereador;Feminino;13;2;0;11
POCINHOS;Vereador;Masculino;34;9;0;25
POCINHOS;Vereador;Feminino;16;2;0;14
POÇO BRANCO;Vereador;Masculino;27;6;0;21
POÇO BRANCO;Vereador;Feminino;12;3;0;9
POÇO DANTAS;Vereador;Masculino;10;7;0;3
POÇO DANTAS;Vereador;Feminino;5;2;0;3
POÇO DAS ANTAS;Vereador;Masculino;17;7;0;10
POÇO DAS ANTAS;Vereador;Feminino;8;2;0;6
POÇO DAS TRINCHEIRAS;Vereador;Masculino;24;8;0;16
POÇO DAS TRINCHEIRAS;Vereador;Feminino;12;1;0;11
POÇO DE JOSÉ DE MOURA;Vereador;Masculino;23;8;0;15
POÇO DE JOSÉ DE MOURA;Vereador;Feminino;11;1;0;10
POÇO FUNDO;Vereador;Masculino;31;7;0;24
POÇO FUNDO;Vereador;Feminino;15;2;0;13
POÇO REDONDO;Vereador;Masculino;41;9;0;32
POÇO REDONDO;Vereador;Feminino;23;2;0;21
POÇO VERDE;Vereador;Masculino;33;9;0;24
POÇO VERDE;Vereador;Feminino;16;2;0;14
POÇÕES;Vereador;Masculino;68;11;0;57
POÇÕES;Vereador;Feminino;31;2;0;29
POCONÉ;Vereador;Masculino;42;7;0;35
POCONÉ;Vereador;Feminino;15;2;0;13
POÇOS DE CALDAS;Vereador;Masculino;165;13;0;152
POÇOS DE CALDAS;Vereador;Feminino;72;2;0;70
POCRANE;Vereador;Masculino;28;7;0;21
POCRANE;Vereador;Feminino;13;2;0;11
POJUCA;Vereador;Masculino;92;10;0;82
POJUCA;Vereador;Feminino;44;3;0;41
POLONI;Vereador;Masculino;23;8;0;15
POLONI;Vereador;Feminino;15;1;0;14
POMBAL;Vereador;Masculino;31;11;0;20
POMBAL;Vereador;Feminino;15;2;0;13
POMBOS;Vereador;Masculino;44;8;0;36
POMBOS;Vereador;Feminino;19;3;0;16
POMERODE;Vereador;Masculino;43;7;0;36
POMERODE;Vereador;Feminino;24;2;0;22
POMPÉIA;Vereador;Masculino;95;10;0;85
POMPÉIA;Vereador;Feminino;48;1;0;47
POMPÉU;Vereador;Masculino;47;6;0;41
POMPÉU;Vereador;Feminino;25;3;0;22
PONGAÍ;Vereador;Masculino;22;7;0;15
PONGAÍ;Vereador;Feminino;10;2;0;8
PONTA DE PEDRAS;Vereador;Masculino;45;6;0;39
PONTA DE PEDRAS;Vereador;Feminino;30;3;0;27
PONTA GROSSA;Vereador;Masculino;279;21;0;258
PONTA GROSSA;Vereador;Feminino;117;2;0;115
PONTA PORÃ;Vereador;Masculino;117;14;0;103
PONTA PORÃ;Vereador;Feminino;54;1;0;53
PONTAL;Vereador;Masculino;120;9;0;111
PONTAL;Vereador;Feminino;61;4;0;57
PONTAL DO ARAGUAIA;Vereador;Masculino;38;6;0;32
PONTAL DO ARAGUAIA;Vereador;Feminino;20;3;0;17
PONTAL DO PARANÁ;Vereador;Masculino;84;7;0;77
PONTAL DO PARANÁ;Vereador;Feminino;40;4;0;36
PONTALINA;Vereador;Masculino;59;9;0;50
PONTALINA;Vereador;Feminino;23;2;0;21
PONTALINDA;Vereador;Masculino;18;8;0;10
PONTALINDA;Vereador;Feminino;8;1;0;7
PONTÃO;Vereador;Masculino;25;7;0;18
PONTÃO;Vereador;Feminino;12;2;0;10
PONTE ALTA;Vereador;Masculino;31;8;0;23
PONTE ALTA;Vereador;Feminino;15;1;0;14
PONTE ALTA DO BOM JESUS;Vereador;Masculino;32;7;0;25
PONTE ALTA DO BOM JESUS;Vereador;Feminino;16;2;0;14
PONTE ALTA DO NORTE;Vereador;Masculino;32;8;0;24
PONTE ALTA DO NORTE;Vereador;Feminino;16;1;0;15
PONTE ALTA DO TOCANTINS;Vereador;Masculino;35;8;0;27
PONTE ALTA DO TOCANTINS;Vereador;Feminino;7;1;0;6
PONTE BRANCA;Vereador;Masculino;12;7;0;5
PONTE BRANCA;Vereador;Feminino;7;2;0;5
PONTE NOVA;Vereador;Masculino;126;10;0;116
PONTE NOVA;Vereador;Feminino;66;3;0;63
PONTE PRETA;Vereador;Masculino;14;7;0;7
PONTE PRETA;Vereador;Feminino;8;2;0;6
PONTE SERRADA;Vereador;Masculino;23;8;0;15
PONTE SERRADA;Vereador;Feminino;13;1;0;12
PONTES E LACERDA;Vereador;Masculino;67;10;0;57
PONTES E LACERDA;Vereador;Feminino;29;1;0;28
PONTES GESTAL;Vereador;Masculino;30;7;0;23
PONTES GESTAL;Vereador;Feminino;15;2;0;13
PONTO BELO;Vereador;Masculino;23;6;0;17
PONTO BELO;Vereador;Feminino;12;3;0;9
PONTO CHIQUE;Vereador;Masculino;23;6;0;17
PONTO CHIQUE;Vereador;Feminino;12;3;0;9
PONTO DOS VOLANTES;Vereador;Masculino;42;9;0;33
PONTO DOS VOLANTES;Vereador;Feminino;21;0;0;21
PONTO NOVO;Vereador;Masculino;35;9;0;26
PONTO NOVO;Vereador;Feminino;18;0;0;18
POPULINA;Vereador;Masculino;23;7;0;16
POPULINA;Vereador;Feminino;13;2;0;11
PORANGA;Vereador;Masculino;12;5;0;7
PORANGA;Vereador;Feminino;9;4;0;5
PORANGABA;Vereador;Masculino;42;9;0;33
PORANGABA;Vereador;Feminino;22;0;0;22
PORANGATU;Vereador;Masculino;100;12;0;88
PORANGATU;Vereador;Feminino;39;1;0;38
PORCIÚNCULA;Vereador;Masculino;60;9;0;51
PORCIÚNCULA;Vereador;Feminino;30;0;0;30
PORECATU;Vereador;Masculino;50;9;0;41
PORECATU;Vereador;Feminino;17;0;0;17
PORTALEGRE;Vereador;Masculino;18;6;0;12
PORTALEGRE;Vereador;Feminino;8;3;0;5
PORTÃO;Vereador;Masculino;64;10;0;54
PORTÃO;Vereador;Feminino;32;1;0;31
PORTEIRÃO;Vereador;Masculino;40;9;0;31
PORTEIRÃO;Vereador;Feminino;22;0;0;22
PORTEIRAS;Vereador;Masculino;19;10;0;9
PORTEIRAS;Vereador;Feminino;8;1;0;7
PORTEIRINHA;Vereador;Masculino;52;13;0;39
PORTEIRINHA;Vereador;Feminino;25;0;0;25
PORTEL;Vereador;Masculino;93;12;0;81
PORTEL;Vereador;Feminino;40;1;0;39
PORTELÂNDIA;Vereador;Masculino;18;6;0;12
PORTELÂNDIA;Vereador;Feminino;11;3;0;8
PORTO;Vereador;Masculino;36;8;0;28
PORTO;Vereador;Feminino;20;1;0;19
PORTO ACRE;Vereador;Masculino;66;8;0;58
PORTO ACRE;Vereador;Feminino;33;1;0;32
PORTO ALEGRE;Vereador;Masculino;395;31;0;364
PORTO ALEGRE;Vereador;Feminino;174;5;0;169
PORTO ALEGRE DO NORTE;Vereador;Masculino;39;6;0;33
PORTO ALEGRE DO NORTE;Vereador;Feminino;23;3;0;20
PORTO ALEGRE DO PIAUÍ;Vereador;Masculino;13;7;0;6
PORTO ALEGRE DO PIAUÍ;Vereador;Feminino;6;2;0;4
PORTO ALEGRE DO TOCANTINS;Vereador;Masculino;20;6;0;14
PORTO ALEGRE DO TOCANTINS;Vereador;Feminino;10;3;0;7
PORTO AMAZONAS;Vereador;Masculino;45;9;0;36
PORTO AMAZONAS;Vereador;Feminino;18;0;0;18
PORTO BARREIRO;Vereador;Masculino;27;8;0;19
PORTO BARREIRO;Vereador;Feminino;11;1;0;10
PORTO BELO;Vereador;Masculino;42;11;0;31
PORTO BELO;Vereador;Feminino;20;0;0;20
PORTO CALVO;Vereador;Masculino;63;10;0;53
PORTO CALVO;Vereador;Feminino;31;1;0;30
PORTO DA FOLHA;Vereador;Masculino;34;10;0;24
PORTO DA FOLHA;Vereador;Feminino;16;1;0;15
PORTO DE MOZ;Vereador;Masculino;54;9;0;45
PORTO DE MOZ;Vereador;Feminino;20;4;0;16
PORTO DE PEDRAS;Vereador;Masculino;32;7;0;25
PORTO DE PEDRAS;Vereador;Feminino;16;2;0;14
PORTO DO MANGUE;Vereador;Masculino;19;8;0;11
PORTO DO MANGUE;Vereador;Feminino;10;1;0;9
PORTO DOS GAÚCHOS;Vereador;Masculino;23;8;0;15
PORTO DOS GAÚCHOS;Vereador;Feminino;12;1;0;11
PORTO ESPERIDIÃO;Vereador;Masculino;34;8;0;26
PORTO ESPERIDIÃO;Vereador;Feminino;17;1;0;16
PORTO ESTRELA;Vereador;Masculino;33;8;0;25
PORTO ESTRELA;Vereador;Feminino;16;1;0;15
PORTO FELIZ;Vereador;Masculino;98;9;0;89
PORTO FELIZ;Vereador;Feminino;51;2;0;49
PORTO FERREIRA;Vereador;Masculino;100;9;0;91
PORTO FERREIRA;Vereador;Feminino;47;2;0;45
PORTO FIRME;Vereador;Masculino;42;9;0;33
PORTO FIRME;Vereador;Feminino;22;0;0;22
PORTO FRANCO;Vereador;Masculino;50;7;0;43
PORTO FRANCO;Vereador;Feminino;24;4;0;20
PORTO GRANDE;Vereador;Masculino;62;7;0;55
PORTO GRANDE;Vereador;Feminino;38;2;0;36
PORTO LUCENA;Vereador;Masculino;18;9;0;9
PORTO LUCENA;Vereador;Feminino;8;0;0;8
PORTO MAUÁ;Vereador;Masculino;19;7;0;12
PORTO MAUÁ;Vereador;Feminino;9;2;0;7
PORTO MURTINHO;Vereador;Masculino;48;6;0;42
PORTO MURTINHO;Vereador;Feminino;22;3;0;19
PORTO NACIONAL;Vereador;Masculino;99;13;0;86
PORTO NACIONAL;Vereador;Feminino;41;0;0;41
PORTO REAL;Vereador;Masculino;99;8;0;91
PORTO REAL;Vereador;Feminino;51;3;0;48
PORTO REAL DO COLÉGIO;Vereador;Masculino;34;11;0;23
PORTO REAL DO COLÉGIO;Vereador;Feminino;15;0;0;15
PORTO RICO;Vereador;Masculino;18;7;0;11
PORTO RICO;Vereador;Feminino;14;2;0;12
PORTO RICO DO MARANHÃO;Vereador;Masculino;40;7;0;33
PORTO RICO DO MARANHÃO;Vereador;Feminino;20;2;0;18
PORTO SEGURO;Vereador;Masculino;227;16;0;211
PORTO SEGURO;Vereador;Feminino;108;1;0;107
PORTO UNIÃO;Vereador;Masculino;54;8;0;46
PORTO UNIÃO;Vereador;Feminino;27;1;0;26
PORTO VELHO;Vereador;Masculino;273;18;0;255
PORTO VELHO;Vereador;Feminino;117;3;0;114
PORTO VERA CRUZ;Vereador;Masculino;10;7;0;3
PORTO VERA CRUZ;Vereador;Feminino;5;2;0;3
PORTO VITÓRIA;Vereador;Masculino;23;9;0;14
PORTO VITÓRIA;Vereador;Feminino;5;0;0;5
PORTO WALTER;Vereador;Masculino;49;9;0;40
PORTO WALTER;Vereador;Feminino;24;0;0;24
PORTO XAVIER;Vereador;Masculino;16;8;0;8
PORTO XAVIER;Vereador;Feminino;9;1;0;8
POSSE;Vereador;Masculino;52;11;0;41
POSSE;Vereador;Feminino;25;2;0;23
POTÉ;Vereador;Masculino;50;10;0;40
POTÉ;Vereador;Feminino;23;1;0;22
POTENGI;Vereador;Masculino;17;6;0;11
POTENGI;Vereador;Feminino;11;3;0;8
POTIM;Vereador;Masculino;87;9;0;78
POTIM;Vereador;Feminino;33;2;0;31
POTIRAGUÁ;Vereador;Masculino;46;9;0;37
POTIRAGUÁ;Vereador;Feminino;23;0;0;23
POTIRENDABA;Vereador;Masculino;58;8;0;50
POTIRENDABA;Vereador;Feminino;29;1;0;28
POTIRETAMA;Vereador;Masculino;23;7;0;16
POTIRETAMA;Vereador;Feminino;13;2;0;11
POUSO ALEGRE;Vereador;Masculino;191;13;0;178
POUSO ALEGRE;Vereador;Feminino;85;2;0;83
POUSO ALTO;Vereador;Masculino;31;9;0;22
POUSO ALTO;Vereador;Feminino;15;0;0;15
POUSO NOVO;Vereador;Masculino;18;8;0;10
POUSO NOVO;Vereador;Feminino;8;1;0;7
POUSO REDONDO;Vereador;Masculino;33;9;0;24
POUSO REDONDO;Vereador;Feminino;17;0;0;17
POXORÉU;Vereador;Masculino;60;11;0;49
POXORÉU;Vereador;Feminino;28;0;0;28
PRACINHA;Vereador;Masculino;31;7;0;24
PRACINHA;Vereador;Feminino;15;2;0;13
PRACUÚBA;Vereador;Masculino;33;7;0;26
PRACUÚBA;Vereador;Feminino;17;2;0;15
PRADO;Vereador;Masculino;98;10;0;88
PRADO;Vereador;Feminino;42;1;0;41
PRADO FERREIRA;Vereador;Masculino;35;7;0;28
PRADO FERREIRA;Vereador;Feminino;7;2;0;5
PRADÓPOLIS;Vereador;Masculino;60;8;0;52
PRADÓPOLIS;Vereador;Feminino;25;1;0;24
PRADOS;Vereador;Masculino;24;9;0;15
PRADOS;Vereador;Feminino;11;0;0;11
PRAIA GRANDE;Vereador;Masculino;222;23;0;199
PRAIA GRANDE;Vereador;Feminino;100;3;0;97
PRAIA NORTE;Vereador;Masculino;20;5;0;15
PRAIA NORTE;Vereador;Feminino;12;4;0;8
PRAINHA;Vereador;Masculino;51;11;0;40
PRAINHA;Vereador;Feminino;22;0;0;22
PRANCHITA;Vereador;Masculino;15;6;0;9
PRANCHITA;Vereador;Feminino;9;3;0;6
PRATA;Vereador;Masculino;73;18;0;55
PRATA;Vereador;Feminino;36;2;0;34
PRATA DO PIAUÍ;Vereador;Masculino;24;8;0;16
PRATA DO PIAUÍ;Vereador;Feminino;10;1;0;9
PRATÂNIA;Vereador;Masculino;54;8;0;46
PRATÂNIA;Vereador;Feminino;28;1;0;27
PRATÁPOLIS;Vereador;Masculino;43;9;0;34
PRATÁPOLIS;Vereador;Feminino;20;0;0;20
PRATINHA;Vereador;Masculino;30;8;0;22
PRATINHA;Vereador;Feminino;12;1;0;11
PRESIDENTE ALVES;Vereador;Masculino;42;7;0;35
PRESIDENTE ALVES;Vereador;Feminino;22;2;0;20
PRESIDENTE BERNARDES;Vereador;Masculino;87;16;0;71
PRESIDENTE BERNARDES;Vereador;Feminino;43;2;0;41
PRESIDENTE CASTELLO BRANCO;Vereador;Masculino;11;7;0;4
PRESIDENTE CASTELLO BRANCO;Vereador;Feminino;7;2;0;5
PRESIDENTE CASTELO BRANCO;Vereador;Masculino;30;7;0;23
PRESIDENTE CASTELO BRANCO;Vereador;Feminino;14;2;0;12
PRESIDENTE DUTRA;Vereador;Masculino;74;19;0;55
PRESIDENTE DUTRA;Vereador;Feminino;38;3;0;35
PRESIDENTE EPITÁCIO;Vereador;Masculino;104;13;0;91
PRESIDENTE EPITÁCIO;Vereador;Feminino;47;0;0;47
PRESIDENTE FIGUEIREDO;Vereador;Masculino;74;10;0;64
PRESIDENTE FIGUEIREDO;Vereador;Feminino;35;1;0;34
PRESIDENTE GETÚLIO;Vereador;Masculino;29;9;0;20
PRESIDENTE GETÚLIO;Vereador;Feminino;15;0;0;15
PRESIDENTE JÂNIO QUADROS;Vereador;Masculino;29;8;0;21
PRESIDENTE JÂNIO QUADROS;Vereador;Feminino;18;1;0;17
PRESIDENTE JUSCELINO;Vereador;Masculino;79;16;0;63
PRESIDENTE JUSCELINO;Vereador;Feminino;44;2;0;42
PRESIDENTE KENNEDY;Vereador;Masculino;80;15;0;65
PRESIDENTE KENNEDY;Vereador;Feminino;38;3;0;35
PRESIDENTE KUBITSCHEK;Vereador;Masculino;33;9;0;24
PRESIDENTE KUBITSCHEK;Vereador;Feminino;11;0;0;11
PRESIDENTE LUCENA;Vereador;Masculino;19;7;0;12
PRESIDENTE LUCENA;Vereador;Feminino;9;2;0;7
PRESIDENTE MÉDICI;Vereador;Masculino;84;13;0;71
PRESIDENTE MÉDICI;Vereador;Feminino;38;5;0;33
PRESIDENTE NEREU;Vereador;Masculino;13;7;0;6
PRESIDENTE NEREU;Vereador;Feminino;8;2;0;6
PRESIDENTE OLEGÁRIO;Vereador;Masculino;53;10;0;43
PRESIDENTE OLEGÁRIO;Vereador;Feminino;26;1;0;25
PRESIDENTE PRUDENTE;Vereador;Masculino;160;11;0;149
PRESIDENTE PRUDENTE;Vereador;Feminino;71;2;0;69
PRESIDENTE SARNEY;Vereador;Masculino;78;10;0;68
PRESIDENTE SARNEY;Vereador;Feminino;35;1;0;34
PRESIDENTE TANCREDO NEVES;Vereador;Masculino;53;10;0;43
PRESIDENTE TANCREDO NEVES;Vereador;Feminino;22;1;0;21
PRESIDENTE VARGAS;Vereador;Masculino;34;6;0;28
PRESIDENTE VARGAS;Vereador;Feminino;15;3;0;12
PRESIDENTE VENCESLAU;Vereador;Masculino;78;13;0;65
PRESIDENTE VENCESLAU;Vereador;Feminino;35;0;0;35
PRIMAVERA;Vereador;Masculino;87;18;0;69
PRIMAVERA;Vereador;Feminino;29;0;0;29
PRIMAVERA DE RONDÔNIA;Vereador;Masculino;26;9;0;17
PRIMAVERA DE RONDÔNIA;Vereador;Feminino;13;0;0;13
PRIMAVERA DO LESTE;Vereador;Masculino;79;13;0;66
PRIMAVERA DO LESTE;Vereador;Feminino;35;2;0;33
PRIMEIRA CRUZ;Vereador;Masculino;42;9;0;33
PRIMEIRA CRUZ;Vereador;Feminino;18;0;0;18
PRIMEIRO DE MAIO;Vereador;Masculino;31;8;0;23
PRIMEIRO DE MAIO;Vereador;Feminino;17;1;0;16
PRINCESA;Vereador;Masculino;21;6;0;15
PRINCESA;Vereador;Feminino;10;3;0;7
PRINCESA ISABEL;Vereador;Masculino;28;10;0;18
PRINCESA ISABEL;Vereador;Feminino;15;1;0;14
PROFESSOR JAMIL;Vereador;Masculino;36;9;0;27
PROFESSOR JAMIL;Vereador;Feminino;18;0;0;18
PROGRESSO;Vereador;Masculino;26;9;0;17
PROGRESSO;Vereador;Feminino;12;0;0;12
PROMISSÃO;Vereador;Masculino;85;13;0;72
PROMISSÃO;Vereador;Feminino;44;0;0;44
PROPRIÁ;Vereador;Masculino;71;9;0;62
PROPRIÁ;Vereador;Feminino;31;2;0;29
PROTÁSIO ALVES;Vereador;Masculino;14;9;0;5
PROTÁSIO ALVES;Vereador;Feminino;7;0;0;7
PRUDENTE DE MORAIS;Vereador;Masculino;77;7;0;70
PRUDENTE DE MORAIS;Vereador;Feminino;41;2;0;39
PRUDENTÓPOLIS;Vereador;Masculino;81;13;0;68
PRUDENTÓPOLIS;Vereador;Feminino;38;0;0;38
PUGMIL;Vereador;Masculino;18;6;0;12
PUGMIL;Vereador;Feminino;11;3;0;8
PUREZA;Vereador;Masculino;24;6;0;18
PUREZA;Vereador;Feminino;11;3;0;8
PUTINGA;Vereador;Masculino;13;7;0;6
PUTINGA;Vereador;Feminino;7;2;0;5
PUXINANÃ;Vereador;Masculino;43;7;0;36
PUXINANÃ;Vereador;Feminino;23;2;0;21
QUADRA;Vereador;Masculino;36;6;0;30
QUADRA;Vereador;Feminino;18;3;0;15
QUARAÍ;Vereador;Masculino;68;8;0;60
QUARAÍ;Vereador;Feminino;32;3;0;29
QUARTEL GERAL;Vereador;Masculino;31;8;0;23
QUARTEL GERAL;Vereador;Feminino;18;1;0;17
QUARTO CENTENÁRIO;Vereador;Masculino;47;9;0;38
QUARTO CENTENÁRIO;Vereador;Feminino;22;0;0;22
QUATÁ;Vereador;Masculino;44;9;0;35
QUATÁ;Vereador;Feminino;22;0;0;22
QUATIGUÁ;Vereador;Masculino;37;7;0;30
QUATIGUÁ;Vereador;Feminino;20;2;0;18
QUATIPURU;Vereador;Masculino;48;7;0;41
QUATIPURU;Vereador;Feminino;23;2;0;21
QUATIS;Vereador;Masculino;86;9;0;77
QUATIS;Vereador;Feminino;41;0;0;41
QUATRO BARRAS;Vereador;Masculino;38;8;0;30
QUATRO BARRAS;Vereador;Feminino;21;1;0;20
QUATRO IRMÃOS;Vereador;Masculino;24;9;0;15
QUATRO IRMÃOS;Vereador;Feminino;12;0;0;12
QUATRO PONTES;Vereador;Masculino;20;5;0;15
QUATRO PONTES;Vereador;Feminino;13;4;0;9
QUEBRANGULO;Vereador;Masculino;41;8;0;33
QUEBRANGULO;Vereador;Feminino;21;1;0;20
QUEDAS DO IGUAÇU;Vereador;Masculino;69;12;0;57
QUEDAS DO IGUAÇU;Vereador;Feminino;30;1;0;29
QUEIMADA NOVA;Vereador;Masculino;18;6;0;12
QUEIMADA NOVA;Vereador;Feminino;8;3;0;5
QUEIMADAS;Vereador;Masculino;138;20;0;118
QUEIMADAS;Vereador;Feminino;63;4;0;59
QUEIMADOS;Vereador;Masculino;141;12;0;129
QUEIMADOS;Vereador;Feminino;63;1;0;62
QUEIROZ;Vereador;Masculino;34;8;0;26
QUEIROZ;Vereador;Feminino;17;1;0;16
QUELUZ;Vereador;Masculino;53;6;0;47
QUELUZ;Vereador;Feminino;27;3;0;24
QUELUZITO;Vereador;Masculino;28;8;0;20
QUELUZITO;Vereador;Feminino;15;1;0;14
QUERÊNCIA;Vereador;Masculino;42;7;0;35
QUERÊNCIA;Vereador;Feminino;20;2;0;18
QUERÊNCIA DO NORTE;Vereador;Masculino;33;8;0;25
QUERÊNCIA DO NORTE;Vereador;Feminino;17;1;0;16
QUEVEDOS;Vereador;Masculino;12;8;0;4
QUEVEDOS;Vereador;Feminino;7;1;0;6
QUILOMBO;Vereador;Masculino;32;8;0;24
QUILOMBO;Vereador;Feminino;14;1;0;13
QUINJINGUE;Vereador;Masculino;25;9;0;16
QUINJINGUE;Vereador;Feminino;11;2;0;9
QUINTA DO SOL;Vereador;Masculino;35;7;0;28
QUINTA DO SOL;Vereador;Feminino;17;2;0;15
QUINTANA;Vereador;Masculino;46;9;0;37
QUINTANA;Vereador;Feminino;24;0;0;24
QUINZE DE NOVEMBRO;Vereador;Masculino;16;8;0;8
QUINZE DE NOVEMBRO;Vereador;Feminino;9;1;0;8
QUIPAPÁ;Vereador;Masculino;56;10;0;46
QUIPAPÁ;Vereador;Feminino;24;1;0;23
QUIRINÓPOLIS;Vereador;Masculino;61;9;0;52
QUIRINÓPOLIS;Vereador;Feminino;37;4;0;33
QUISSAMÃ;Vereador;Masculino;83;7;0;76
QUISSAMÃ;Vereador;Feminino;39;2;0;37
QUITANDINHA;Vereador;Masculino;61;8;0;53
QUITANDINHA;Vereador;Feminino;27;1;0;26
QUITERIANÓPOLIS;Vereador;Masculino;19;9;0;10
QUITERIANÓPOLIS;Vereador;Feminino;8;2;0;6
QUIXABA;Vereador;Masculino;28;17;0;11
QUIXABA;Vereador;Feminino;13;1;0;12
QUIXABEIRA;Vereador;Masculino;18;7;0;11
QUIXABEIRA;Vereador;Feminino;7;2;0;5
QUIXADÁ;Vereador;Masculino;85;16;0;69
QUIXADÁ;Vereador;Feminino;39;1;0;38
QUIXELÔ;Vereador;Masculino;28;11;0;17
QUIXELÔ;Vereador;Feminino;17;0;0;17
QUIXERAMOBIM;Vereador;Masculino;76;11;0;65
QUIXERAMOBIM;Vereador;Feminino;35;4;0;31
QUIXERÉ;Vereador;Masculino;45;8;0;37
QUIXERÉ;Vereador;Feminino;16;3;0;13
RAFAEL FERNANDES;Vereador;Masculino;17;7;0;10
RAFAEL FERNANDES;Vereador;Feminino;9;2;0;7
RAFAEL GODEIRO;Vereador;Masculino;16;7;0;9
RAFAEL GODEIRO;Vereador;Feminino;7;2;0;5
RAFAEL JAMBEIRO;Vereador;Masculino;43;9;0;34
RAFAEL JAMBEIRO;Vereador;Feminino;19;2;0;17
RAFARD;Vereador;Masculino;50;7;0;43
RAFARD;Vereador;Feminino;24;2;0;22
RAMILÂNDIA;Vereador;Masculino;27;5;0;22
RAMILÂNDIA;Vereador;Feminino;10;4;0;6
RANCHARIA;Vereador;Masculino;73;8;0;65
RANCHARIA;Vereador;Feminino;36;3;0;33
RANCHO ALEGRE;Vereador;Masculino;24;9;0;15
RANCHO ALEGRE;Vereador;Feminino;7;0;0;7
RANCHO ALEGRE D'OESTE;Vereador;Masculino;12;7;0;5
RANCHO ALEGRE D'OESTE;Vereador;Feminino;6;2;0;4
RANCHO QUEIMADO;Vereador;Masculino;17;8;0;9
RANCHO QUEIMADO;Vereador;Feminino;9;1;0;8
RAPOSA;Vereador;Masculino;69;9;0;60
RAPOSA;Vereador;Feminino;30;2;0;28
RAPOSOS;Vereador;Masculino;81;8;0;73
RAPOSOS;Vereador;Feminino;37;1;0;36
RAUL SOARES;Vereador;Masculino;82;10;0;72
RAUL SOARES;Vereador;Feminino;39;1;0;38
REALEZA;Vereador;Masculino;36;7;0;29
REALEZA;Vereador;Feminino;14;2;0;12
REBOUÇAS;Vereador;Masculino;43;7;0;36
REBOUÇAS;Vereador;Feminino;20;2;0;18
RECIFE;Vereador;Masculino;559;33;0;526
RECIFE;Vereador;Feminino;223;6;0;217
RECREIO;Vereador;Masculino;45;8;0;37
RECREIO;Vereador;Feminino;25;1;0;24
RECURSOLÂNDIA;Vereador;Masculino;18;7;0;11
RECURSOLÂNDIA;Vereador;Feminino;8;2;0;6
REDENÇÃO;Vereador;Masculino;174;21;0;153
REDENÇÃO;Vereador;Feminino;80;5;0;75
REDENÇÃO DA SERRA;Vereador;Masculino;43;9;0;34
REDENÇÃO DA SERRA;Vereador;Feminino;21;0;0;21
REDENÇÃO DO GURGUÉIA;Vereador;Masculino;18;8;0;10
REDENÇÃO DO GURGUÉIA;Vereador;Feminino;9;1;0;8
REDENTORA;Vereador;Masculino;27;9;0;18
REDENTORA;Vereador;Feminino;12;0;0;12
REDUTO;Vereador;Masculino;30;9;0;21
REDUTO;Vereador;Feminino;15;0;0;15
REGENERAÇÃO;Vereador;Masculino;33;10;0;23
REGENERAÇÃO;Vereador;Feminino;17;1;0;16
REGENTE FEIJÓ;Vereador;Masculino;51;8;0;43
REGENTE FEIJÓ;Vereador;Feminino;23;1;0;22
REGINÓPOLIS;Vereador;Masculino;41;8;0;33
REGINÓPOLIS;Vereador;Feminino;21;1;0;20
REGISTRO;Vereador;Masculino;147;12;0;135
REGISTRO;Vereador;Feminino;66;1;0;65
RELVADO;Vereador;Masculino;16;6;0;10
RELVADO;Vereador;Feminino;8;3;0;5
REMANSO;Vereador;Masculino;32;9;0;23
REMANSO;Vereador;Feminino;15;2;0;13
REMÍGIO;Vereador;Masculino;39;10;0;29
REMÍGIO;Vereador;Feminino;19;1;0;18
RENASCENÇA;Vereador;Masculino;16;8;0;8
RENASCENÇA;Vereador;Feminino;8;1;0;7
RERIUTABA;Vereador;Masculino;19;7;0;12
RERIUTABA;Vereador;Feminino;9;4;0;5
RESENDE;Vereador;Masculino;222;16;0;206
RESENDE;Vereador;Feminino;107;1;0;106
RESENDE COSTA;Vereador;Masculino;42;9;0;33
RESENDE COSTA;Vereador;Feminino;18;0;0;18
RESERVA;Vereador;Masculino;59;11;0;48
RESERVA;Vereador;Feminino;27;0;0;27
RESERVA DO CABAÇAL;Vereador;Masculino;23;8;0;15
RESERVA DO CABAÇAL;Vereador;Feminino;11;1;0;10
RESERVA DO IGUAÇU;Vereador;Masculino;29;9;0;20
RESERVA DO IGUAÇU;Vereador;Feminino;18;0;0;18
RESPLENDOR;Vereador;Masculino;81;10;0;71
RESPLENDOR;Vereador;Feminino;39;1;0;38
RESSAQUINHA;Vereador;Masculino;32;8;0;24
RESSAQUINHA;Vereador;Feminino;16;1;0;15
RESTINGA;Vereador;Masculino;48;9;0;39
RESTINGA;Vereador;Feminino;24;0;0;24
RESTINGA SÊCA;Vereador;Masculino;37;9;0;28
RESTINGA SÊCA;Vereador;Feminino;20;0;0;20
RETIROLÂNDIA;Vereador;Masculino;30;9;0;21
RETIROLÂNDIA;Vereador;Feminino;14;0;0;14
RIACHÃO;Vereador;Masculino;81;18;0;63
RIACHÃO;Vereador;Feminino;38;2;0;36
RIACHÃO DAS NEVES;Vereador;Masculino;64;10;0;54
RIACHÃO DAS NEVES;Vereador;Feminino;30;1;0;29
RIACHÃO DO BACAMARTE;Vereador;Masculino;19;7;0;12
RIACHÃO DO BACAMARTE;Vereador;Feminino;10;2;0;8
RIACHÃO DO DANTAS;Vereador;Masculino;42;10;0;32
RIACHÃO DO DANTAS;Vereador;Feminino;18;1;0;17
RIACHÃO DO JACUÍPE;Vereador;Masculino;40;12;0;28
RIACHÃO DO JACUÍPE;Vereador;Feminino;16;1;0;15
RIACHÃO DO POÇO;Vereador;Masculino;22;7;0;15
RIACHÃO DO POÇO;Vereador;Feminino;12;2;0;10
RIACHINHO;Vereador;Masculino;46;14;0;32
RIACHINHO;Vereador;Feminino;20;4;0;16
RIACHO DA CRUZ;Vereador;Masculino;18;8;0;10
RIACHO DA CRUZ;Vereador;Feminino;9;1;0;8
RIACHO DAS ALMAS;Vereador;Masculino;35;10;0;25
RIACHO DAS ALMAS;Vereador;Feminino;8;1;0;7
RIACHO DE SANTANA;Vereador;Masculino;42;18;0;24
RIACHO DE SANTANA;Vereador;Feminino;23;4;0;19
RIACHO DE SANTO ANTÔNIO;Vereador;Masculino;29;8;0;21
RIACHO DE SANTO ANTÔNIO;Vereador;Feminino;12;1;0;11
RIACHO DOS CAVALOS;Vereador;Masculino;22;8;0;14
RIACHO DOS CAVALOS;Vereador;Feminino;13;1;0;12
RIACHO DOS MACHADOS;Vereador;Masculino;42;8;0;34
RIACHO DOS MACHADOS;Vereador;Feminino;22;1;0;21
RIACHO FRIO;Vereador;Masculino;18;8;0;10
RIACHO FRIO;Vereador;Feminino;11;1;0;10
RIACHUELO;Vereador;Masculino;45;15;0;30
RIACHUELO;Vereador;Feminino;24;3;0;21
RIALMA;Vereador;Masculino;33;6;0;27
RIALMA;Vereador;Feminino;17;3;0;14
RIANÁPOLIS;Vereador;Masculino;23;7;0;16
RIANÁPOLIS;Vereador;Feminino;13;2;0;11
RIBAMAR FIQUENE;Vereador;Masculino;36;7;0;29
RIBAMAR FIQUENE;Vereador;Feminino;21;2;0;19
RIBAS DO RIO PARDO;Vereador;Masculino;52;8;0;44
RIBAS DO RIO PARDO;Vereador;Feminino;26;3;0;23
RIBEIRA;Vereador;Masculino;26;8;0;18
RIBEIRA;Vereador;Feminino;13;1;0;12
RIBEIRA DO AMPARO;Vereador;Masculino;38;7;0;31
RIBEIRA DO AMPARO;Vereador;Feminino;15;2;0;13
RIBEIRA DO PIAUÍ;Vereador;Masculino;17;5;0;12
RIBEIRA DO PIAUÍ;Vereador;Feminino;10;4;0;6
RIBEIRA DO POMBAL;Vereador;Masculino;37;13;0;24
RIBEIRA DO POMBAL;Vereador;Feminino;17;0;0;17
RIBEIRÃO;Vereador;Masculino;87;13;0;74
RIBEIRÃO;Vereador;Feminino;16;0;0;16
RIBEIRÃO BONITO;Vereador;Masculino;44;8;0;36
RIBEIRÃO BONITO;Vereador;Feminino;21;1;0;20
RIBEIRÃO BRANCO;Vereador;Masculino;44;10;0;34
RIBEIRÃO BRANCO;Vereador;Feminino;21;1;0;20
RIBEIRÃO CASCALHEIRA;Vereador;Masculino;36;9;0;27
RIBEIRÃO CASCALHEIRA;Vereador;Feminino;18;0;0;18
RIBEIRÃO CLARO;Vereador;Masculino;45;8;0;37
RIBEIRÃO CLARO;Vereador;Feminino;18;1;0;17
RIBEIRÃO CORRENTE;Vereador;Masculino;33;8;0;25
RIBEIRÃO CORRENTE;Vereador;Feminino;16;1;0;15
RIBEIRÃO DAS NEVES;Vereador;Masculino;184;14;0;170
RIBEIRÃO DAS NEVES;Vereador;Feminino;80;0;0;80
RIBEIRÃO DO LARGO;Vereador;Masculino;40;8;0;32
RIBEIRÃO DO LARGO;Vereador;Feminino;20;1;0;19
RIBEIRÃO DO PINHAL;Vereador;Masculino;39;8;0;31
RIBEIRÃO DO PINHAL;Vereador;Feminino;18;1;0;17
RIBEIRÃO DO SUL;Vereador;Masculino;46;8;0;38
RIBEIRÃO DO SUL;Vereador;Feminino;24;1;0;23
RIBEIRÃO DOS ÍNDIOS;Vereador;Masculino;20;7;0;13
RIBEIRÃO DOS ÍNDIOS;Vereador;Feminino;9;2;0;7
RIBEIRÃO GRANDE;Vereador;Masculino;41;8;0;33
RIBEIRÃO GRANDE;Vereador;Feminino;23;1;0;22
RIBEIRÃO PIRES;Vereador;Masculino;219;14;0;205
RIBEIRÃO PIRES;Vereador;Feminino;100;3;0;97
RIBEIRÃO PRETO;Vereador;Masculino;299;20;0;279
RIBEIRÃO PRETO;Vereador;Feminino;133;2;0;131
RIBEIRÃO VERMELHO;Vereador;Masculino;35;8;0;27
RIBEIRÃO VERMELHO;Vereador;Feminino;17;1;0;16
RIBEIRÃOZINHO;Vereador;Masculino;15;8;0;7
RIBEIRÃOZINHO;Vereador;Feminino;9;1;0;8
RIBEIRO GONÇALVES;Vereador;Masculino;19;8;0;11
RIBEIRO GONÇALVES;Vereador;Feminino;11;1;0;10
RIBEIRÓPOLIS;Vereador;Masculino;31;9;0;22
RIBEIRÓPOLIS;Vereador;Feminino;14;2;0;12
RIFAINA;Vereador;Masculino;23;8;0;15
RIFAINA;Vereador;Feminino;11;1;0;10
RINCÃO;Vereador;Masculino;63;8;0;55
RINCÃO;Vereador;Feminino;34;1;0;33
RINÓPOLIS;Vereador;Masculino;40;9;0;31
RINÓPOLIS;Vereador;Feminino;17;0;0;17
RIO ACIMA;Vereador;Masculino;70;8;0;62
RIO ACIMA;Vereador;Feminino;34;1;0;33
RIO AZUL;Vereador;Masculino;58;8;0;50
RIO AZUL;Vereador;Feminino;23;1;0;22
RIO BANANAL;Vereador;Masculino;30;10;0;20
RIO BANANAL;Vereador;Feminino;14;1;0;13
RIO BOM;Vereador;Masculino;33;8;0;25
RIO BOM;Vereador;Feminino;15;1;0;14
RIO BONITO;Vereador;Masculino;87;8;0;79
RIO BONITO;Vereador;Feminino;41;2;0;39
RIO BONITO DO IGUAÇU;Vereador;Masculino;57;9;0;48
RIO BONITO DO IGUAÇU;Vereador;Feminino;26;0;0;26
RIO BRANCO;Vereador;Masculino;245;20;0;225
RIO BRANCO;Vereador;Feminino;113;6;0;107
RIO BRANCO DO IVAÍ;Vereador;Masculino;20;9;0;11
RIO BRANCO DO IVAÍ;Vereador;Feminino;8;0;0;8
RIO BRANCO DO SUL;Vereador;Masculino;41;11;0;30
RIO BRANCO DO SUL;Vereador;Feminino;18;0;0;18
RIO BRILHANTE;Vereador;Masculino;61;11;0;50
RIO BRILHANTE;Vereador;Feminino;28;2;0;26
RIO CASCA;Vereador;Masculino;47;8;0;39
RIO CASCA;Vereador;Feminino;23;1;0;22
RIO CLARO;Vereador;Masculino;209;21;0;188
RIO CLARO;Vereador;Feminino;105;2;0;103
RIO CRESPO;Vereador;Masculino;31;8;0;23
RIO CRESPO;Vereador;Feminino;13;1;0;12
RIO DA CONCEIÇÃO;Vereador;Masculino;16;7;0;9
RIO DA CONCEIÇÃO;Vereador;Feminino;8;2;0;6
RIO DAS ANTAS;Vereador;Masculino;17;9;0;8
RIO DAS ANTAS;Vereador;Feminino;9;0;0;9
RIO DAS FLORES;Vereador;Masculino;42;9;0;33
RIO DAS FLORES;Vereador;Feminino;19;0;0;19
RIO DAS OSTRAS;Vereador;Masculino;176;13;0;163
RIO DAS OSTRAS;Vereador;Feminino;79;0;0;79
RIO DAS PEDRAS;Vereador;Masculino;95;6;0;89
RIO DAS PEDRAS;Vereador;Feminino;49;3;0;46
RIO DE CONTAS;Vereador;Masculino;30;6;0;24
RIO DE CONTAS;Vereador;Feminino;14;3;0;11
RIO DE JANEIRO;Vereador;Masculino;1.138;43;0;1.095
RIO DE JANEIRO;Vereador;Feminino;489;8;0;481
RIO DO ANTÔNIO;Vereador;Masculino;24;9;0;15
RIO DO ANTÔNIO;Vereador;Feminino;12;0;0;12
RIO DO CAMPO;Vereador;Masculino;27;9;0;18
RIO DO CAMPO;Vereador;Feminino;13;0;0;13
RIO DO FOGO;Vereador;Masculino;30;8;0;22
RIO DO FOGO;Vereador;Feminino;16;1;0;15
RIO DO OESTE;Vereador;Masculino;23;8;0;15
RIO DO OESTE;Vereador;Feminino;10;1;0;9
RIO DO PIRES;Vereador;Masculino;23;9;0;14
RIO DO PIRES;Vereador;Feminino;11;0;0;11
RIO DO PRADO;Vereador;Masculino;20;9;0;11
RIO DO PRADO;Vereador;Feminino;9;0;0;9
RIO DO SUL;Vereador;Masculino;48;7;0;41
RIO DO SUL;Vereador;Feminino;21;3;0;18
RIO DOCE;Vereador;Masculino;35;9;0;26
RIO DOCE;Vereador;Feminino;19;0;0;19
RIO DOS BOIS;Vereador;Masculino;28;8;0;20
RIO DOS BOIS;Vereador;Feminino;13;1;0;12
RIO DOS CEDROS;Vereador;Masculino;27;8;0;19
RIO DOS CEDROS;Vereador;Feminino;14;1;0;13
RIO DOS ÍNDIOS;Vereador;Masculino;18;7;0;11
RIO DOS ÍNDIOS;Vereador;Feminino;8;2;0;6
RIO ESPERA;Vereador;Masculino;37;7;0;30
RIO ESPERA;Vereador;Feminino;16;2;0;14
RIO FORMOSO;Vereador;Masculino;61;9;0;52
RIO FORMOSO;Vereador;Feminino;29;2;0;27
RIO FORTUNA;Vereador;Masculino;18;8;0;10
RIO FORTUNA;Vereador;Feminino;8;1;0;7
RIO GRANDE;Vereador;Masculino;233;18;0;215
RIO GRANDE;Vereador;Feminino;104;3;0;101
RIO GRANDE DA SERRA;Vereador;Masculino;107;12;0;95
RIO GRANDE DA SERRA;Vereador;Feminino;52;1;0;51
RIO GRANDE DO PIAUÍ;Vereador;Masculino;21;7;0;14
RIO GRANDE DO PIAUÍ;Vereador;Feminino;11;2;0;9
RIO LARGO;Vereador;Masculino;90;9;0;81
RIO LARGO;Vereador;Feminino;40;1;0;39
RIO MANSO;Vereador;Masculino;33;8;0;25
RIO MANSO;Vereador;Feminino;17;1;0;16
RIO MARIA;Vereador;Masculino;47;9;0;38
RIO MARIA;Vereador;Feminino;23;2;0;21
RIO NEGRINHO;Vereador;Masculino;90;8;0;82
RIO NEGRINHO;Vereador;Feminino;47;1;0;46
RIO NEGRO;Vereador;Masculino;91;18;0;73
RIO NEGRO;Vereador;Feminino;45;0;0;45
RIO NOVO;Vereador;Masculino;50;8;0;42
RIO NOVO;Vereador;Feminino;28;1;0;27
RIO NOVO DO SUL;Vereador;Masculino;30;7;0;23
RIO NOVO DO SUL;Vereador;Feminino;15;2;0;13
RIO PARANAÍBA;Vereador;Masculino;35;9;0;26
RIO PARANAÍBA;Vereador;Feminino;16;0;0;16
RIO PARDO;Vereador;Masculino;78;10;0;68
RIO PARDO;Vereador;Feminino;37;3;0;34
RIO PARDO DE MINAS;Vereador;Masculino;45;10;0;35
RIO PARDO DE MINAS;Vereador;Feminino;22;1;0;21
RIO PIRACICABA;Vereador;Masculino;72;9;0;63
RIO PIRACICABA;Vereador;Feminino;38;0;0;38
RIO POMBA;Vereador;Masculino;34;8;0;26
RIO POMBA;Vereador;Feminino;18;1;0;17
RIO PRETO;Vereador;Masculino;42;9;0;33
RIO PRETO;Vereador;Feminino;20;0;0;20
RIO PRETO DA EVA;Vereador;Masculino;79;11;0;68
RIO PRETO DA EVA;Vereador;Feminino;39;0;0;39
RIO QUENTE;Vereador;Masculino;39;9;0;30
RIO QUENTE;Vereador;Feminino;16;0;0;16
RIO REAL;Vereador;Masculino;51;13;0;38
RIO REAL;Vereador;Feminino;23;0;0;23
RIO RUFINO;Vereador;Masculino;19;8;0;11
RIO RUFINO;Vereador;Feminino;7;1;0;6
RIO SONO;Vereador;Masculino;27;7;0;20
RIO SONO;Vereador;Feminino;15;2;0;13
RIO TINTO;Vereador;Masculino;38;9;0;29
RIO TINTO;Vereador;Feminino;15;2;0;13
RIO VERDE;Vereador;Masculino;147;17;0;130
RIO VERDE;Vereador;Feminino;60;4;0;56
RIO VERDE DE MATO GROSSO;Vereador;Masculino;51;9;0;42
RIO VERDE DE MATO GROSSO;Vereador;Feminino;23;2;0;21
RIO VERMELHO;Vereador;Masculino;48;8;0;40
RIO VERMELHO;Vereador;Feminino;22;1;0;21
RIOLÂNDIA;Vereador;Masculino;24;5;0;19
RIOLÂNDIA;Vereador;Feminino;13;4;0;9
RIOZINHO;Vereador;Masculino;22;7;0;15
RIOZINHO;Vereador;Feminino;11;2;0;9
RIQUEZA;Vereador;Masculino;18;7;0;11
RIQUEZA;Vereador;Feminino;11;2;0;9
RITÁPOLIS;Vereador;Masculino;53;9;0;44
RITÁPOLIS;Vereador;Feminino;25;0;0;25
RIVERSUL;Vereador;Masculino;34;9;0;25
RIVERSUL;Vereador;Feminino;21;0;0;21
ROCA SALES;Vereador;Masculino;33;9;0;24
ROCA SALES;Vereador;Feminino;17;0;0;17
ROCHEDO;Vereador;Masculino;34;7;0;27
ROCHEDO;Vereador;Feminino;15;2;0;13
ROCHEDO DE MINAS;Vereador;Masculino;34;7;0;27
ROCHEDO DE MINAS;Vereador;Feminino;20;2;0;18
RODEIO;Vereador;Masculino;33;7;0;26
RODEIO;Vereador;Feminino;17;2;0;15
RODEIO BONITO;Vereador;Masculino;17;8;0;9
RODEIO BONITO;Vereador;Feminino;10;1;0;9
RODEIRO;Vereador;Masculino;20;7;0;13
RODEIRO;Vereador;Feminino;9;2;0;7
RODELAS;Vereador;Masculino;32;9;0;23
RODELAS;Vereador;Feminino;5;0;0;5
RODOLFO FERNANDES;Vereador;Masculino;16;8;0;8
RODOLFO FERNANDES;Vereador;Feminino;9;1;0;8
RODRIGUES ALVES;Vereador;Masculino;38;8;0;30
RODRIGUES ALVES;Vereador;Feminino;18;1;0;17
ROLADOR;Vereador;Masculino;14;7;0;7
ROLADOR;Vereador;Feminino;7;2;0;5
ROLÂNDIA;Vereador;Masculino;70;9;0;61
ROLÂNDIA;Vereador;Feminino;30;1;0;29
ROLANTE;Vereador;Masculino;40;9;0;31
ROLANTE;Vereador;Feminino;20;0;0;20
ROLIM DE MOURA;Vereador;Masculino;86;11;0;75
ROLIM DE MOURA;Vereador;Feminino;37;0;0;37
ROMARIA;Vereador;Masculino;23;7;0;16
ROMARIA;Vereador;Feminino;12;2;0;10
ROMELÂNDIA;Vereador;Masculino;23;8;0;15
ROMELÂNDIA;Vereador;Feminino;11;1;0;10
RONCADOR;Vereador;Masculino;36;8;0;28
RONCADOR;Vereador;Feminino;18;1;0;17
RONDA ALTA;Vereador;Masculino;18;9;0;9
RONDA ALTA;Vereador;Feminino;8;0;0;8
RONDINHA;Vereador;Masculino;16;6;0;10
RONDINHA;Vereador;Feminino;9;3;0;6
RONDOLÂNDIA;Vereador;Masculino;24;6;0;18
RONDOLÂNDIA;Vereador;Feminino;11;3;0;8
RONDON;Vereador;Masculino;29;8;0;21
RONDON;Vereador;Feminino;13;1;0;12
RONDON DO PARÁ;Vereador;Masculino;81;11;0;70
RONDON DO PARÁ;Vereador;Feminino;38;2;0;36
RONDONÓPOLIS;Vereador;Masculino;192;21;0;171
RONDONÓPOLIS;Vereador;Feminino;89;0;0;89
ROQUE GONZALES;Vereador;Masculino;14;7;0;7
ROQUE GONZALES;Vereador;Feminino;8;2;0;6
RORAINÓPOLIS;Vereador;Masculino;67;10;0;57
RORAINÓPOLIS;Vereador;Feminino;34;1;0;33
ROSANA;Vereador;Masculino;98;10;0;88
ROSANA;Vereador;Feminino;48;1;0;47
ROSÁRIO;Vereador;Masculino;79;13;0;66
ROSÁRIO;Vereador;Feminino;37;0;0;37
ROSÁRIO DA LIMEIRA;Vereador;Masculino;48;7;0;41
ROSÁRIO DA LIMEIRA;Vereador;Feminino;24;2;0;22
ROSÁRIO DO CATETE;Vereador;Masculino;24;8;0;16
ROSÁRIO DO CATETE;Vereador;Feminino;12;1;0;11
ROSÁRIO DO IVAÍ;Vereador;Masculino;27;8;0;19
ROSÁRIO DO IVAÍ;Vereador;Feminino;14;1;0;13
ROSÁRIO DO SUL;Vereador;Masculino;80;11;0;69
ROSÁRIO DO SUL;Vereador;Feminino;33;2;0;31
ROSÁRIO OESTE;Vereador;Masculino;40;9;0;31
ROSÁRIO OESTE;Vereador;Feminino;18;2;0;16
ROSEIRA;Vereador;Masculino;61;7;0;54
ROSEIRA;Vereador;Feminino;30;2;0;28
ROTEIRO;Vereador;Masculino;21;7;0;14
ROTEIRO;Vereador;Feminino;10;2;0;8
RUBELITA;Vereador;Masculino;27;8;0;19
RUBELITA;Vereador;Feminino;14;1;0;13
RUBIÁCEA;Vereador;Masculino;36;9;0;27
RUBIÁCEA;Vereador;Feminino;16;0;0;16
RUBIATABA;Vereador;Masculino;58;9;0;49
RUBIATABA;Vereador;Feminino;30;2;0;28
RUBIM;Vereador;Masculino;30;7;0;23
RUBIM;Vereador;Feminino;14;2;0;12
RUBINÉIA;Vereador;Masculino;36;9;0;27
RUBINÉIA;Vereador;Feminino;20;0;0;20
RURÓPOLIS;Vereador;Masculino;77;8;0;69
RURÓPOLIS;Vereador;Feminino;42;5;0;37
RUSSAS;Vereador;Masculino;87;15;0;72
RUSSAS;Vereador;Feminino;37;0;0;37
RUY BARBOSA;Vereador;Masculino;51;16;0;35
RUY BARBOSA;Vereador;Feminino;26;4;0;22
SABARÁ;Vereador;Masculino;237;13;0;224
SABARÁ;Vereador;Feminino;96;2;0;94
SABÁUDIA;Vereador;Masculino;31;6;0;25
SABÁUDIA;Vereador;Feminino;15;3;0;12
SABINO;Vereador;Masculino;46;8;0;38
SABINO;Vereador;Feminino;23;1;0;22
SABINÓPOLIS;Vereador;Masculino;53;7;0;46
SABINÓPOLIS;Vereador;Feminino;30;2;0;28
SABOEIRO;Vereador;Masculino;29;8;0;21
SABOEIRO;Vereador;Feminino;13;3;0;10
SACRAMENTO;Vereador;Masculino;57;9;0;48
SACRAMENTO;Vereador;Feminino;30;0;0;30
SAGRADA FAMÍLIA;Vereador;Masculino;18;8;0;10
SAGRADA FAMÍLIA;Vereador;Feminino;8;1;0;7
SAGRES;Vereador;Masculino;29;8;0;21
SAGRES;Vereador;Feminino;17;1;0;16
SAIRÉ;Vereador;Masculino;18;7;0;11
SAIRÉ;Vereador;Feminino;6;2;0;4
SALDANHA MARINHO;Vereador;Masculino;21;6;0;15
SALDANHA MARINHO;Vereador;Feminino;10;3;0;7
SALES;Vereador;Masculino;26;8;0;18
SALES;Vereador;Feminino;16;1;0;15
SALES OLIVEIRA;Vereador;Masculino;33;8;0;25
SALES OLIVEIRA;Vereador;Feminino;14;1;0;13
SALESÓPOLIS;Vereador;Masculino;82;9;0;73
SALESÓPOLIS;Vereador;Feminino;38;2;0;36
SALETE;Vereador;Masculino;33;6;0;27
SALETE;Vereador;Feminino;16;3;0;13
SALGADINHO;Vereador;Masculino;27;16;0;11
SALGADINHO;Vereador;Feminino;13;2;0;11
SALGADO;Vereador;Masculino;46;9;0;37
SALGADO;Vereador;Feminino;19;2;0;17
SALGADO DE SÃO FÉLIX;Vereador;Masculino;28;7;0;21
SALGADO DE SÃO FÉLIX;Vereador;Feminino;11;2;0;9
SALGADO FILHO;Vereador;Masculino;15;7;0;8
SALGADO FILHO;Vereador;Feminino;7;2;0;5
SALGUEIRO;Vereador;Masculino;66;12;0;54
SALGUEIRO;Vereador;Feminino;27;2;0;25
SALINAS;Vereador;Masculino;64;10;0;54
SALINAS;Vereador;Feminino;30;3;0;27
SALINAS DA MARGARIDA;Vereador;Masculino;70;8;0;62
SALINAS DA MARGARIDA;Vereador;Feminino;32;1;0;31
SALINÓPOLIS;Vereador;Masculino;102;12;0;90
SALINÓPOLIS;Vereador;Feminino;47;1;0;46
SALITRE;Vereador;Masculino;26;7;0;19
SALITRE;Vereador;Feminino;10;4;0;6
SALMOURÃO;Vereador;Masculino;33;8;0;25
SALMOURÃO;Vereador;Feminino;19;1;0;18
SALOÁ;Vereador;Masculino;17;6;0;11
SALOÁ;Vereador;Feminino;7;3;0;4
SALTINHO;Vereador;Masculino;58;16;0;42
SALTINHO;Vereador;Feminino;27;2;0;25
SALTO;Vereador;Masculino;196;15;0;181
SALTO;Vereador;Feminino;95;2;0;93
SALTO DA DIVISA;Vereador;Masculino;39;7;0;32
SALTO DA DIVISA;Vereador;Feminino;20;2;0;18
SALTO DE PIRAPORA;Vereador;Masculino;61;8;0;53
SALTO DE PIRAPORA;Vereador;Feminino;32;1;0;31
SALTO DO CÉU;Vereador;Masculino;21;9;0;12
SALTO DO CÉU;Vereador;Feminino;12;0;0;12
SALTO DO ITARARÉ;Vereador;Masculino;32;6;0;26
SALTO DO ITARARÉ;Vereador;Feminino;18;3;0;15
SALTO DO JACUÍ;Vereador;Masculino;37;7;0;30
SALTO DO JACUÍ;Vereador;Feminino;18;2;0;16
SALTO DO LONTRA;Vereador;Masculino;29;8;0;21
SALTO DO LONTRA;Vereador;Feminino;13;1;0;12
SALTO GRANDE;Vereador;Masculino;59;8;0;51
SALTO GRANDE;Vereador;Feminino;33;1;0;32
SALTO VELOSO;Vereador;Masculino;17;9;0;8
SALTO VELOSO;Vereador;Feminino;8;0;0;8
SALVADOR;Vereador;Masculino;843;38;0;805
SALVADOR;Vereador;Feminino;323;5;0;318
SALVADOR DAS MISSÕES;Vereador;Masculino;12;6;0;6
SALVADOR DAS MISSÕES;Vereador;Feminino;6;3;0;3
SALVADOR DO SUL;Vereador;Masculino;26;8;0;18
SALVADOR DO SUL;Vereador;Feminino;13;1;0;12
SALVATERRA;Vereador;Masculino;66;9;0;57
SALVATERRA;Vereador;Feminino;31;2;0;29
SAMBAÍBA;Vereador;Masculino;24;7;0;17
SAMBAÍBA;Vereador;Feminino;12;2;0;10
SAMPAIO;Vereador;Masculino;18;6;0;12
SAMPAIO;Vereador;Feminino;12;3;0;9
SANANDUVA;Vereador;Masculino;20;8;0;12
SANANDUVA;Vereador;Feminino;9;1;0;8
SANCLERLÂNDIA;Vereador;Masculino;42;9;0;33
SANCLERLÂNDIA;Vereador;Feminino;19;0;0;19
SANDOLÂNDIA;Vereador;Masculino;25;5;0;20
SANDOLÂNDIA;Vereador;Feminino;12;4;0;8
SANDOVALINA;Vereador;Masculino;50;7;0;43
SANDOVALINA;Vereador;Feminino;25;2;0;23
SANGÃO;Vereador;Masculino;19;8;0;11
SANGÃO;Vereador;Feminino;10;1;0;9
SANHARÓ;Vereador;Masculino;29;10;0;19
SANHARÓ;Vereador;Feminino;14;1;0;13
SANTA ADÉLIA;Vereador;Masculino;12;9;0;3
SANTA ADÉLIA;Vereador;Feminino;5;0;0;5
SANTA ALBERTINA;Vereador;Masculino;21;9;0;12
SANTA ALBERTINA;Vereador;Feminino;10;0;0;10
SANTA AMÉLIA;Vereador;Masculino;29;9;0;20
SANTA AMÉLIA;Vereador;Feminino;14;0;0;14
SANTA BÁRBARA;Vereador;Masculino;142;21;0;121
SANTA BÁRBARA;Vereador;Feminino;63;1;0;62
SANTA BÁRBARA DE GOIÁS;Vereador;Masculino;33;8;0;25
SANTA BÁRBARA DE GOIÁS;Vereador;Feminino;18;1;0;17
SANTA BÁRBARA DO LESTE;Vereador;Masculino;36;7;0;29
SANTA BÁRBARA DO LESTE;Vereador;Feminino;20;2;0;18
SANTA BÁRBARA DO MONTE VERDE;Vereador;Masculino;22;9;0;13
SANTA BÁRBARA DO MONTE VERDE;Vereador;Feminino;11;0;0;11
SANTA BÁRBARA DO PARÁ;Vereador;Masculino;94;8;0;86
SANTA BÁRBARA DO PARÁ;Vereador;Feminino;43;3;0;40
SANTA BÁRBARA DO SUL;Vereador;Masculino;24;7;0;17
SANTA BÁRBARA DO SUL;Vereador;Feminino;12;2;0;10
SANTA BÁRBARA DO TUGÚRIO;Vereador;Masculino;46;9;0;37
SANTA BÁRBARA DO TUGÚRIO;Vereador;Feminino;25;0;0;25
SANTA BÁRBARA D'OESTE;Vereador;Masculino;278;19;0;259
SANTA BÁRBARA D'OESTE;Vereador;Feminino;123;0;0;123
SANTA BRANCA;Vereador;Masculino;92;7;0;85
SANTA BRANCA;Vereador;Feminino;48;2;0;46
SANTA BRÍGIDA;Vereador;Masculino;30;10;0;20
SANTA BRÍGIDA;Vereador;Feminino;15;1;0;14
SANTA CARMEM;Vereador;Masculino;29;7;0;22
SANTA CARMEM;Vereador;Feminino;13;2;0;11
SANTA CECÍLIA;Vereador;Masculino;95;18;0;77
SANTA CECÍLIA;Vereador;Feminino;47;2;0;45
SANTA CECÍLIA DO PAVÃO;Vereador;Masculino;25;9;0;16
SANTA CECÍLIA DO PAVÃO;Vereador;Feminino;12;0;0;12
SANTA CECÍLIA DO SUL;Vereador;Masculino;16;8;0;8
SANTA CECÍLIA DO SUL;Vereador;Feminino;8;1;0;7
SANTA CLARA DO SUL;Vereador;Masculino;23;7;0;16
SANTA CLARA DO SUL;Vereador;Feminino;12;2;0;10
SANTA CLARA D'OESTE;Vereador;Masculino;19;9;0;10
SANTA CLARA D'OESTE;Vereador;Feminino;10;0;0;10
SANTA CRUZ;Vereador;Masculino;85;23;0;62
SANTA CRUZ;Vereador;Feminino;44;4;0;40
SANTA CRUZ CABRÁLIA;Vereador;Masculino;121;10;0;111
SANTA CRUZ CABRÁLIA;Vereador;Feminino;58;1;0;57
SANTA CRUZ DA BAIXA VERDE;Vereador;Masculino;45;8;0;37
SANTA CRUZ DA BAIXA VERDE;Vereador;Feminino;25;1;0;24
SANTA CRUZ DA CONCEIÇÃO;Vereador;Masculino;31;8;0;23
SANTA CRUZ DA CONCEIÇÃO;Vereador;Feminino;15;1;0;14
SANTA CRUZ DA ESPERANÇA;Vereador;Masculino;33;7;0;26
SANTA CRUZ DA ESPERANÇA;Vereador;Feminino;18;2;0;16
SANTA CRUZ DA VITÓRIA;Vereador;Masculino;18;5;0;13
SANTA CRUZ DA VITÓRIA;Vereador;Feminino;8;4;0;4
SANTA CRUZ DAS PALMEIRAS;Vereador;Masculino;80;9;0;71
SANTA CRUZ DAS PALMEIRAS;Vereador;Feminino;40;2;0;38
SANTA CRUZ DE GOIÁS;Vereador;Masculino;25;9;0;16
SANTA CRUZ DE GOIÁS;Vereador;Feminino;13;0;0;13
SANTA CRUZ DE MINAS;Vereador;Masculino;61;9;0;52
SANTA CRUZ DE MINAS;Vereador;Feminino;30;0;0;30
SANTA CRUZ DE MONTE CASTELO;Vereador;Masculino;33;9;0;24
SANTA CRUZ DE MONTE CASTELO;Vereador;Feminino;15;0;0;15
SANTA CRUZ DE SALINAS;Vereador;Masculino;32;8;0;24
SANTA CRUZ DE SALINAS;Vereador;Feminino;16;1;0;15
SANTA CRUZ DO ARARI;Vereador;Masculino;42;8;0;34
SANTA CRUZ DO ARARI;Vereador;Feminino;21;1;0;20
SANTA CRUZ DO CAPIBARIBE;Vereador;Masculino;65;16;0;49
SANTA CRUZ DO CAPIBARIBE;Vereador;Feminino;17;1;0;16
SANTA CRUZ DO ESCALVADO;Vereador;Masculino;38;7;0;31
SANTA CRUZ DO ESCALVADO;Vereador;Feminino;21;2;0;19
SANTA CRUZ DO PIAUÍ;Vereador;Masculino;15;6;0;9
SANTA CRUZ DO PIAUÍ;Vereador;Feminino;8;3;0;5
SANTA CRUZ DO RIO PARDO;Vereador;Masculino;69;12;0;57
SANTA CRUZ DO RIO PARDO;Vereador;Feminino;30;1;0;29
SANTA CRUZ DO SUL;Vereador;Masculino;122;15;0;107
SANTA CRUZ DO SUL;Vereador;Feminino;58;2;0;56
SANTA CRUZ DO XINGU;Vereador;Masculino;23;7;0;16
SANTA CRUZ DO XINGU;Vereador;Feminino;10;2;0;8
SANTA CRUZ DOS MILAGRES;Vereador;Masculino;20;8;0;12
SANTA CRUZ DOS MILAGRES;Vereador;Feminino;11;1;0;10
SANTA EFIGÊNIA DE MINAS;Vereador;Masculino;38;8;0;30
SANTA EFIGÊNIA DE MINAS;Vereador;Feminino;18;1;0;17
SANTA ERNESTINA;Vereador;Masculino;40;9;0;31
SANTA ERNESTINA;Vereador;Feminino;20;0;0;20
SANTA FÉ;Vereador;Masculino;28;5;0;23
SANTA FÉ;Vereador;Feminino;16;4;0;12
SANTA FÉ DE GOIÁS;Vereador;Masculino;22;7;0;15
SANTA FÉ DE GOIÁS;Vereador;Feminino;12;2;0;10
SANTA FÉ DE MINAS;Vereador;Masculino;23;9;0;14
SANTA FÉ DE MINAS;Vereador;Feminino;12;0;0;12
SANTA FÉ DO ARAGUAIA;Vereador;Masculino;32;9;0;23
SANTA FÉ DO ARAGUAIA;Vereador;Feminino;23;0;0;23
SANTA FÉ DO SUL;Vereador;Masculino;64;8;0;56
SANTA FÉ DO SUL;Vereador;Feminino;33;1;0;32
SANTA FILOMENA;Vereador;Masculino;58;16;0;42
SANTA FILOMENA;Vereador;Feminino;30;2;0;28
SANTA FILOMENA DO MARANHÃO;Vereador;Masculino;15;5;0;10
SANTA FILOMENA DO MARANHÃO;Vereador;Feminino;16;4;0;12
SANTA GERTRUDES;Vereador;Masculino;93;9;0;84
SANTA GERTRUDES;Vereador;Feminino;49;0;0;49
SANTA HELENA;Vereador;Masculino;129;32;0;97
SANTA HELENA;Vereador;Feminino;66;4;0;62
SANTA HELENA DE GOIÁS;Vereador;Masculino;76;12;0;64
SANTA HELENA DE GOIÁS;Vereador;Feminino;32;1;0;31
SANTA HELENA DE MINAS;Vereador;Masculino;27;8;0;19
SANTA HELENA DE MINAS;Vereador;Feminino;13;1;0;12
SANTA INÊS;Vereador;Masculino;195;35;0;160
SANTA INÊS;Vereador;Feminino;98;9;0;89
SANTA ISABEL;Vereador;Masculino;188;20;0;168
SANTA ISABEL;Vereador;Feminino;85;4;0;81
SANTA ISABEL DO IVAÍ;Vereador;Masculino;39;9;0;30
SANTA ISABEL DO IVAÍ;Vereador;Feminino;19;0;0;19
SANTA ISABEL DO PARÁ;Vereador;Masculino;108;12;0;96
SANTA ISABEL DO PARÁ;Vereador;Feminino;46;1;0;45
SANTA ISABEL DO RIO NEGRO;Vereador;Masculino;36;6;0;30
SANTA ISABEL DO RIO NEGRO;Vereador;Feminino;19;3;0;16
SANTA IZABEL DO OESTE;Vereador;Masculino;25;8;0;17
SANTA IZABEL DO OESTE;Vereador;Feminino;14;1;0;13
SANTA JULIANA;Vereador;Masculino;30;8;0;22
SANTA JULIANA;Vereador;Feminino;17;1;0;16
SANTA LEOPOLDINA;Vereador;Masculino;45;8;0;37
SANTA LEOPOLDINA;Vereador;Feminino;26;1;0;25
SANTA LÚCIA;Vereador;Masculino;92;16;0;76
SANTA LÚCIA;Vereador;Feminino;41;2;0;39
SANTA LUZ;Vereador;Masculino;14;7;0;7
SANTA LUZ;Vereador;Feminino;5;2;0;3
SANTA LUZIA;Vereador;Masculino;399;45;0;354
SANTA LUZIA;Vereador;Feminino;178;5;0;173
SANTA LUZIA DO ITANHY;Vereador;Masculino;58;8;0;50
SANTA LUZIA DO ITANHY;Vereador;Feminino;28;1;0;27
SANTA LUZIA DO NORTE;Vereador;Masculino;34;8;0;26
SANTA LUZIA DO NORTE;Vereador;Feminino;17;1;0;16
SANTA LUZIA DO OESTE;Vereador;Masculino;39;8;0;31
SANTA LUZIA DO OESTE;Vereador;Feminino;16;1;0;15
SANTA LUZIA DO PARÁ;Vereador;Masculino;44;9;0;35
SANTA LUZIA DO PARÁ;Vereador;Feminino;20;2;0;18
SANTA LUZIA DO PARUÁ;Vereador;Masculino;51;10;0;41
SANTA LUZIA DO PARUÁ;Vereador;Feminino;24;1;0;23
SANTA MARGARIDA;Vereador;Masculino;30;10;0;20
SANTA MARGARIDA;Vereador;Feminino;14;1;0;13
SANTA MARGARIDA DO SUL;Vereador;Masculino;22;8;0;14
SANTA MARGARIDA DO SUL;Vereador;Feminino;10;1;0;9
SANTA MARIA;Vereador;Masculino;171;24;0;147
SANTA MARIA;Vereador;Feminino;79;6;0;73
SANTA MARIA DA BOA VISTA;Vereador;Masculino;60;11;0;49
SANTA MARIA DA BOA VISTA;Vereador;Feminino;25;2;0;23
SANTA MARIA DA SERRA;Vereador;Masculino;34;9;0;25
SANTA MARIA DA SERRA;Vereador;Feminino;15;0;0;15
SANTA MARIA DA VITÓRIA;Vereador;Masculino;46;13;0;33
SANTA MARIA DA VITÓRIA;Vereador;Feminino;18;0;0;18
SANTA MARIA DAS BARREIRAS;Vereador;Masculino;70;10;0;60
SANTA MARIA DAS BARREIRAS;Vereador;Feminino;29;1;0;28
SANTA MARIA DE ITABIRA;Vereador;Masculino;44;7;0;37
SANTA MARIA DE ITABIRA;Vereador;Feminino;22;2;0;20
SANTA MARIA DE JETIBÁ;Vereador;Masculino;63;12;0;51
SANTA MARIA DE JETIBÁ;Vereador;Feminino;29;1;0;28
SANTA MARIA DO CAMBUCÁ;Vereador;Masculino;32;9;0;23
SANTA MARIA DO CAMBUCÁ;Vereador;Feminino;6;0;0;6
SANTA MARIA DO HERVAL;Vereador;Masculino;23;7;0;16
SANTA MARIA DO HERVAL;Vereador;Feminino;11;2;0;9
SANTA MARIA DO OESTE;Vereador;Masculino;39;7;0;32
SANTA MARIA DO OESTE;Vereador;Feminino;21;2;0;19
SANTA MARIA DO PARÁ;Vereador;Masculino;48;9;0;39
SANTA MARIA DO PARÁ;Vereador;Feminino;25;2;0;23
SANTA MARIA DO SALTO;Vereador;Masculino;16;8;0;8
SANTA MARIA DO SALTO;Vereador;Feminino;9;1;0;8
SANTA MARIA DO SUAÇUÍ;Vereador;Masculino;47;8;0;39
SANTA MARIA DO SUAÇUÍ;Vereador;Feminino;25;1;0;24
SANTA MARIA DO TOCANTINS;Vereador;Masculino;25;9;0;16
SANTA MARIA DO TOCANTINS;Vereador;Feminino;13;0;0;13
SANTA MARIA MADALENA;Vereador;Masculino;43;8;0;35
SANTA MARIA MADALENA;Vereador;Feminino;22;1;0;21
SANTA MARIANA;Vereador;Masculino;33;9;0;24
SANTA MARIANA;Vereador;Feminino;16;0;0;16
SANTA MERCEDES;Vereador;Masculino;29;8;0;21
SANTA MERCEDES;Vereador;Feminino;17;1;0;16
SANTA MÔNICA;Vereador;Masculino;29;8;0;21
SANTA MÔNICA;Vereador;Feminino;14;1;0;13
SANTA QUITÉRIA;Vereador;Masculino;40;11;0;29
SANTA QUITÉRIA;Vereador;Feminino;22;2;0;20
SANTA QUITÉRIA DO MARANHÃO;Vereador;Masculino;30;8;0;22
SANTA QUITÉRIA DO MARANHÃO;Vereador;Feminino;15;3;0;12
SANTA RITA;Vereador;Masculino;237;27;0;210
SANTA RITA;Vereador;Feminino;99;5;0;94
SANTA RITA DE CALDAS;Vereador;Masculino;26;8;0;18
SANTA RITA DE CALDAS;Vereador;Feminino;13;1;0;12
SANTA RITA DE CÁSSIA;Vereador;Masculino;54;11;0;43
SANTA RITA DE CÁSSIA;Vereador;Feminino;27;0;0;27
SANTA RITA DE IBITIPOCA;Vereador;Masculino;23;8;0;15
SANTA RITA DE IBITIPOCA;Vereador;Feminino;11;1;0;10
SANTA RITA DE JACUTINGA;Vereador;Masculino;25;7;0;18
SANTA RITA DE JACUTINGA;Vereador;Feminino;12;2;0;10
SANTA RITA DE MINAS;Vereador;Masculino;34;8;0;26
SANTA RITA DE MINAS;Vereador;Feminino;15;1;0;14
SANTA RITA DO ARAGUAIA;Vereador;Masculino;41;9;0;32
SANTA RITA DO ARAGUAIA;Vereador;Feminino;22;0;0;22
SANTA RITA DO ITUETO;Vereador;Masculino;25;8;0;17
SANTA RITA DO ITUETO;Vereador;Feminino;13;1;0;12
SANTA RITA DO NOVO DESTINO;Vereador;Masculino;27;8;0;19
SANTA RITA DO NOVO DESTINO;Vereador;Feminino;15;1;0;14
SANTA RITA DO PARDO;Vereador;Masculino;30;8;0;22
SANTA RITA DO PARDO;Vereador;Feminino;16;1;0;15
SANTA RITA DO PASSA QUATRO;Vereador;Masculino;82;8;0;74
SANTA RITA DO PASSA QUATRO;Vereador;Feminino;42;1;0;41
SANTA RITA DO SAPUCAÍ;Vereador;Masculino;101;11;0;90
SANTA RITA DO SAPUCAÍ;Vereador;Feminino;46;2;0;44
SANTA RITA DO TOCANTINS;Vereador;Masculino;29;8;0;21
SANTA RITA DO TOCANTINS;Vereador;Feminino;14;1;0;13
SANTA RITA DO TRIVELATO;Vereador;Masculino;18;8;0;10
SANTA RITA DO TRIVELATO;Vereador;Feminino;9;1;0;8
SANTA RITA D'OESTE;Vereador;Masculino;12;8;0;4
SANTA RITA D'OESTE;Vereador;Feminino;6;1;0;5
SANTA ROSA;Vereador;Masculino;75;12;0;63
SANTA ROSA;Vereador;Feminino;34;3;0;31
SANTA ROSA DA SERRA;Vereador;Masculino;25;8;0;17
SANTA ROSA DA SERRA;Vereador;Feminino;12;1;0;11
SANTA ROSA DE GOIÁS;Vereador;Masculino;39;7;0;32
SANTA ROSA DE GOIÁS;Vereador;Feminino;18;2;0;16
SANTA ROSA DE LIMA;Vereador;Masculino;39;14;0;25
SANTA ROSA DE LIMA;Vereador;Feminino;19;4;0;15
SANTA ROSA DE VITERBO;Vereador;Masculino;62;9;0;53
SANTA ROSA DE VITERBO;Vereador;Feminino;30;2;0;28
SANTA ROSA DO PIAUÍ;Vereador;Masculino;15;7;0;8
SANTA ROSA DO PIAUÍ;Vereador;Feminino;8;2;0;6
SANTA ROSA DO PURUS;Vereador;Masculino;30;6;0;24
SANTA ROSA DO PURUS;Vereador;Feminino;13;3;0;10
SANTA ROSA DO SUL;Vereador;Masculino;25;8;0;17
SANTA ROSA DO SUL;Vereador;Feminino;13;1;0;12
SANTA ROSA DO TOCANTINS;Vereador;Masculino;24;8;0;16
SANTA ROSA DO TOCANTINS;Vereador;Feminino;12;1;0;11
SANTA SALETE;Vereador;Masculino;21;6;0;15
SANTA SALETE;Vereador;Feminino;11;3;0;8
SANTA TERESA;Vereador;Masculino;64;10;0;54
SANTA TERESA;Vereador;Feminino;33;1;0;32
SANTA TERESINHA;Vereador;Masculino;22;6;0;16
SANTA TERESINHA;Vereador;Feminino;11;3;0;8
SANTA TEREZA;Vereador;Masculino;16;7;0;9
SANTA TEREZA;Vereador;Feminino;8;2;0;6
SANTA TEREZA DE GOIÁS;Vereador;Masculino;26;8;0;18
SANTA TEREZA DE GOIÁS;Vereador;Feminino;17;1;0;16
SANTA TEREZA DO OESTE;Vereador;Masculino;42;9;0;33
SANTA TEREZA DO OESTE;Vereador;Feminino;19;0;0;19
SANTA TEREZA DO TOCANTINS;Vereador;Masculino;20;9;0;11
SANTA TEREZA DO TOCANTINS;Vereador;Feminino;8;0;0;8
SANTA TEREZINHA;Vereador;Masculino;122;29;0;93
SANTA TEREZINHA;Vereador;Feminino;60;7;0;53
SANTA TEREZINHA DE GOIÁS;Vereador;Masculino;38;8;0;30
SANTA TEREZINHA DE GOIÁS;Vereador;Feminino;18;1;0;17
SANTA TEREZINHA DE ITAIPU;Vereador;Masculino;53;8;0;45
SANTA TEREZINHA DE ITAIPU;Vereador;Feminino;29;1;0;28
SANTA TEREZINHA DO PROGRESSO;Vereador;Masculino;29;8;0;21
SANTA TEREZINHA DO PROGRESSO;Vereador;Feminino;17;1;0;16
SANTA TEREZINHA DO TOCANTINS;Vereador;Masculino;18;7;0;11
SANTA TEREZINHA DO TOCANTINS;Vereador;Feminino;8;2;0;6
SANTA VITÓRIA;Vereador;Masculino;50;9;0;41
SANTA VITÓRIA;Vereador;Feminino;26;2;0;24
SANTA VITÓRIA DO PALMAR;Vereador;Masculino;74;12;0;62
SANTA VITÓRIA DO PALMAR;Vereador;Feminino;34;1;0;33
SANTALUZ;Vereador;Masculino;44;13;0;31
SANTALUZ;Vereador;Feminino;19;0;0;19
SANTANA;Vereador;Masculino;168;22;0;146
SANTANA;Vereador;Feminino;71;2;0;69
SANTANA DA BOA VISTA;Vereador;Masculino;24;9;0;15
SANTANA DA BOA VISTA;Vereador;Feminino;14;0;0;14
SANTANA DA PONTE PENSA;Vereador;Masculino;19;8;0;11
SANTANA DA PONTE PENSA;Vereador;Feminino;9;1;0;8
SANTANA DA VARGEM;Vereador;Masculino;39;9;0;30
SANTANA DA VARGEM;Vereador;Feminino;18;0;0;18
SANTANA DE CATAGUASES;Vereador;Masculino;34;8;0;26
SANTANA DE CATAGUASES;Vereador;Feminino;19;1;0;18
SANTANA DE MANGUEIRA;Vereador;Masculino;20;9;0;11
SANTANA DE MANGUEIRA;Vereador;Feminino;10;0;0;10
SANTANA DE PARNAÍBA;Vereador;Masculino;165;15;0;150
SANTANA DE PARNAÍBA;Vereador;Feminino;76;0;0;76
SANTANA DE PIRAPAMA;Vereador;Masculino;45;9;0;36
SANTANA DE PIRAPAMA;Vereador;Feminino;21;0;0;21
SANTANA DO ACARAÚ;Vereador;Masculino;27;7;0;20
SANTANA DO ACARAÚ;Vereador;Feminino;15;4;0;11
SANTANA DO ARAGUAIA;Vereador;Masculino;97;11;0;86
SANTANA DO ARAGUAIA;Vereador;Feminino;42;4;0;38
SANTANA DO CARIRI;Vereador;Masculino;26;10;0;16
SANTANA DO CARIRI;Vereador;Feminino;14;1;0;13
SANTANA DO DESERTO;Vereador;Masculino;43;9;0;34
SANTANA DO DESERTO;Vereador;Feminino;21;0;0;21
SANTANA DO GARAMBÉU;Vereador;Masculino;17;9;0;8
SANTANA DO GARAMBÉU;Vereador;Feminino;8;0;0;8
SANTANA DO IPANEMA;Vereador;Masculino;76;8;0;68
SANTANA DO IPANEMA;Vereador;Feminino;40;1;0;39
SANTANA DO ITARARÉ;Vereador;Masculino;33;9;0;24
SANTANA DO ITARARÉ;Vereador;Feminino;16;0;0;16
SANTANA DO JACARÉ;Vereador;Masculino;44;7;0;37
SANTANA DO JACARÉ;Vereador;Feminino;23;2;0;21
SANTANA DO LIVRAMENTO;Vereador;Masculino;140;14;0;126
SANTANA DO LIVRAMENTO;Vereador;Feminino;74;3;0;71
SANTANA DO MANHUAÇU;Vereador;Masculino;35;9;0;26
SANTANA DO MANHUAÇU;Vereador;Feminino;17;0;0;17
SANTANA DO MARANHÃO;Vereador;Masculino;27;6;0;21
SANTANA DO MARANHÃO;Vereador;Feminino;15;3;0;12
SANTANA DO MATOS;Vereador;Masculino;22;8;0;14
SANTANA DO MATOS;Vereador;Feminino;10;1;0;9
SANTANA DO MUNDAÚ;Vereador;Masculino;23;8;0;15
SANTANA DO MUNDAÚ;Vereador;Feminino;12;1;0;11
SANTANA DO PARAÍSO;Vereador;Masculino;78;9;0;69
SANTANA DO PARAÍSO;Vereador;Feminino;37;2;0;35
SANTANA DO PIAUÍ;Vereador;Masculino;15;7;0;8
SANTANA DO PIAUÍ;Vereador;Feminino;8;2;0;6
SANTANA DO RIACHO;Vereador;Masculino;43;7;0;36
SANTANA DO RIACHO;Vereador;Feminino;24;2;0;22
SANTANA DO SÃO FRANCISCO;Vereador;Masculino;25;8;0;17
SANTANA DO SÃO FRANCISCO;Vereador;Feminino;8;1;0;7
SANTANA DO SERIDÓ;Vereador;Masculino;14;7;0;7
SANTANA DO SERIDÓ;Vereador;Feminino;7;2;0;5
SANTANA DOS GARROTES;Vereador;Masculino;16;8;0;8
SANTANA DOS GARROTES;Vereador;Feminino;9;1;0;8
SANTANA DOS MONTES;Vereador;Masculino;38;7;0;31
SANTANA DOS MONTES;Vereador;Feminino;19;2;0;17
SANTANÓPOLIS;Vereador;Masculino;39;9;0;30
SANTANÓPOLIS;Vereador;Feminino;16;0;0;16
SANTARÉM;Vereador;Masculino;244;18;0;226
SANTARÉM;Vereador;Feminino;109;3;0;106
SANTARÉM NOVO;Vereador;Masculino;39;6;0;33
SANTARÉM NOVO;Vereador;Feminino;14;3;0;11
SANTIAGO;Vereador;Masculino;52;11;0;41
SANTIAGO;Vereador;Feminino;23;2;0;21
SANTIAGO DO SUL;Vereador;Masculino;17;6;0;11
SANTIAGO DO SUL;Vereador;Feminino;8;3;0;5
SANTO AFONSO;Vereador;Masculino;20;8;0;12
SANTO AFONSO;Vereador;Feminino;9;1;0;8
SANTO AMARO;Vereador;Masculino;147;15;0;132
SANTO AMARO;Vereador;Feminino;72;0;0;72
SANTO AMARO DA IMPERATRIZ;Vereador;Masculino;39;11;0;28
SANTO AMARO DA IMPERATRIZ;Vereador;Feminino;20;0;0;20
SANTO AMARO DAS BROTAS;Vereador;Masculino;46;8;0;38
SANTO AMARO DAS BROTAS;Vereador;Feminino;25;1;0;24
SANTO AMARO DO MARANHÃO;Vereador;Masculino;28;7;0;21
SANTO AMARO DO MARANHÃO;Vereador;Feminino;9;2;0;7
SANTO ANASTÁCIO;Vereador;Masculino;96;9;0;87
SANTO ANASTÁCIO;Vereador;Feminino;28;2;0;26
SANTO ANDRÉ;Vereador;Masculino;369;26;0;343
SANTO ANDRÉ;Vereador;Feminino;167;4;0;163
SANTO ÂNGELO;Vereador;Masculino;73;13;0;60
SANTO ÂNGELO;Vereador;Feminino;33;2;0;31
SANTO ANTÔNIO;Vereador;Masculino;41;7;0;34
SANTO ANTÔNIO;Vereador;Feminino;17;4;0;13
SANTO ANTÔNIO DA ALEGRIA;Vereador;Masculino;54;7;0;47
SANTO ANTÔNIO DA ALEGRIA;Vereador;Feminino;32;2;0;30
SANTO ANTÔNIO DA BARRA;Vereador;Masculino;24;7;0;17
SANTO ANTÔNIO DA BARRA;Vereador;Feminino;16;2;0;14
SANTO ANTÔNIO DA PATRULHA;Vereador;Masculino;53;10;0;43
SANTO ANTÔNIO DA PATRULHA;Vereador;Feminino;26;3;0;23
SANTO ANTÔNIO DA PLATINA;Vereador;Masculino;80;9;0;71
SANTO ANTÔNIO DA PLATINA;Vereador;Feminino;25;0;0;25
SANTO ANTÔNIO DAS MISSÕES;Vereador;Masculino;26;7;0;19
SANTO ANTÔNIO DAS MISSÕES;Vereador;Feminino;13;2;0;11
SANTO ANTÔNIO DE GOIÁS;Vereador;Masculino;43;8;0;35
SANTO ANTÔNIO DE GOIÁS;Vereador;Feminino;17;1;0;16
SANTO ANTÔNIO DE JESUS;Vereador;Masculino;97;13;0;84
SANTO ANTÔNIO DE JESUS;Vereador;Feminino;46;1;0;45
SANTO ANTÔNIO DE LISBOA;Vereador;Masculino;10;4;0;6
SANTO ANTÔNIO DE LISBOA;Vereador;Feminino;6;5;0;1
SANTO ANTÔNIO DE PÁDUA;Vereador;Masculino;99;10;0;89
SANTO ANTÔNIO DE PÁDUA;Vereador;Feminino;49;3;0;46
SANTO ANTÔNIO DE POSSE;Vereador;Masculino;125;11;0;114
SANTO ANTÔNIO DE POSSE;Vereador;Feminino;62;0;0;62
SANTO ANTÔNIO DO AMPARO;Vereador;Masculino;62;9;0;53
SANTO ANTÔNIO DO AMPARO;Vereador;Feminino;30;2;0;28
SANTO ANTÔNIO DO ARACANGUÁ;Vereador;Masculino;52;9;0;43
SANTO ANTÔNIO DO ARACANGUÁ;Vereador;Feminino;27;0;0;27
SANTO ANTÔNIO DO AVENTUREIRO;Vereador;Masculino;21;9;0;12
SANTO ANTÔNIO DO AVENTUREIRO;Vereador;Feminino;11;0;0;11
SANTO ANTONIO DO CAIUÁ;Vereador;Masculino;33;8;0;25
SANTO ANTONIO DO CAIUÁ;Vereador;Feminino;15;1;0;14
SANTO ANTÔNIO DO DESCOBERTO;Vereador;Masculino;157;15;0;142
SANTO ANTÔNIO DO DESCOBERTO;Vereador;Feminino;67;0;0;67
SANTO ANTÔNIO DO GRAMA;Vereador;Masculino;43;8;0;35
SANTO ANTÔNIO DO GRAMA;Vereador;Feminino;21;1;0;20
SANTO ANTÔNIO DO IÇÁ;Vereador;Masculino;59;9;0;50
SANTO ANTÔNIO DO IÇÁ;Vereador;Feminino;29;2;0;27
SANTO ANTÔNIO DO ITAMBÉ;Vereador;Masculino;34;9;0;25
SANTO ANTÔNIO DO ITAMBÉ;Vereador;Feminino;15;0;0;15
SANTO ANTÔNIO DO JACINTO;Vereador;Masculino;31;7;0;24
SANTO ANTÔNIO DO JACINTO;Vereador;Feminino;18;2;0;16
SANTO ANTÔNIO DO JARDIM;Vereador;Masculino;40;8;0;32
SANTO ANTÔNIO DO JARDIM;Vereador;Feminino;21;1;0;20
SANTO ANTÔNIO DO LESTE;Vereador;Masculino;26;8;0;18
SANTO ANTÔNIO DO LESTE;Vereador;Feminino;12;1;0;11
SANTO ANTÔNIO DO LEVERGER;Vereador;Masculino;61;10;0;51
SANTO ANTÔNIO DO LEVERGER;Vereador;Feminino;30;1;0;29
SANTO ANTÔNIO DO MONTE;Vereador;Masculino;67;11;0;56
SANTO ANTÔNIO DO MONTE;Vereador;Feminino;31;0;0;31
SANTO ANTÔNIO DO PALMA;Vereador;Masculino;19;7;0;12
SANTO ANTÔNIO DO PALMA;Vereador;Feminino;9;2;0;7
SANTO ANTÔNIO DO PARAÍSO;Vereador;Masculino;26;9;0;17
SANTO ANTÔNIO DO PARAÍSO;Vereador;Feminino;13;0;0;13
SANTO ANTÔNIO DO PINHAL;Vereador;Masculino;47;8;0;39
SANTO ANTÔNIO DO PINHAL;Vereador;Feminino;28;1;0;27
SANTO ANTÔNIO DO PLANALTO;Vereador;Masculino;18;8;0;10
SANTO ANTÔNIO DO PLANALTO;Vereador;Feminino;12;1;0;11
SANTO ANTÔNIO DO RETIRO;Vereador;Masculino;33;8;0;25
SANTO ANTÔNIO DO RETIRO;Vereador;Feminino;17;1;0;16
SANTO ANTÔNIO DO RIO ABAIXO;Vereador;Masculino;27;7;0;20
SANTO ANTÔNIO DO RIO ABAIXO;Vereador;Feminino;13;2;0;11
SANTO ANTÔNIO DO SUDOESTE;Vereador;Masculino;27;11;0;16
SANTO ANTÔNIO DO SUDOESTE;Vereador;Feminino;12;0;0;12
SANTO ANTÔNIO DO TAUÁ;Vereador;Masculino;115;9;0;106
SANTO ANTÔNIO DO TAUÁ;Vereador;Feminino;54;2;0;52
SANTO ANTÔNIO DOS LOPES;Vereador;Masculino;52;8;0;44
SANTO ANTÔNIO DOS LOPES;Vereador;Feminino;22;1;0;21
SANTO ANTÔNIO DOS MILAGRES;Vereador;Masculino;18;8;0;10
SANTO ANTÔNIO DOS MILAGRES;Vereador;Feminino;9;1;0;8
SANTO AUGUSTO;Vereador;Masculino;19;6;0;13
SANTO AUGUSTO;Vereador;Feminino;13;3;0;10
SANTO CRISTO;Vereador;Masculino;15;7;0;8
SANTO CRISTO;Vereador;Feminino;9;2;0;7
SANTO ESTEVÃO;Vereador;Masculino;97;13;0;84
SANTO ESTEVÃO;Vereador;Feminino;45;0;0;45
SANTO EXPEDITO;Vereador;Masculino;29;9;0;20
SANTO EXPEDITO;Vereador;Feminino;14;0;0;14
SANTO EXPEDITO DO SUL;Vereador;Masculino;9;7;0;2
SANTO EXPEDITO DO SUL;Vereador;Feminino;5;2;0;3
SANTO HIPÓLITO;Vereador;Masculino;31;7;0;24
SANTO HIPÓLITO;Vereador;Feminino;15;2;0;13
SANTO INÁCIO;Vereador;Masculino;24;7;0;17
SANTO INÁCIO;Vereador;Feminino;10;2;0;8
SANTO INÁCIO DO PIAUÍ;Vereador;Masculino;17;9;0;8
SANTO INÁCIO DO PIAUÍ;Vereador;Feminino;7;0;0;7
SANTÓPOLIS DO AGUAPEÍ;Vereador;Masculino;37;8;0;29
SANTÓPOLIS DO AGUAPEÍ;Vereador;Feminino;19;1;0;18
SANTOS;Vereador;Masculino;303;21;0;282
SANTOS;Vereador;Feminino;143;0;0;143
SANTOS DUMONT;Vereador;Masculino;116;10;0;106
SANTOS DUMONT;Vereador;Feminino;58;1;0;57
SÃO BENEDITO;Vereador;Masculino;28;11;0;17
SÃO BENEDITO;Vereador;Feminino;14;2;0;12
SÃO BENEDITO DO RIO PRETO;Vereador;Masculino;29;9;0;20
SÃO BENEDITO DO RIO PRETO;Vereador;Feminino;18;2;0;16
SÃO BENEDITO DO SUL;Vereador;Masculino;27;8;0;19
SÃO BENEDITO DO SUL;Vereador;Feminino;14;1;0;13
SÃO BENTINHO;Vereador;Masculino;18;9;0;9
SÃO BENTINHO;Vereador;Feminino;9;0;0;9
SÃO BENTO;Vereador;Masculino;155;23;0;132
SÃO BENTO;Vereador;Feminino;73;3;0;70
SÃO BENTO ABADE;Vereador;Masculino;57;8;0;49
SÃO BENTO ABADE;Vereador;Feminino;33;1;0;32
SÃO BENTO DO NORTE;Vereador;Masculino;23;7;0;16
SÃO BENTO DO NORTE;Vereador;Feminino;11;2;0;9
SÃO BENTO DO SAPUCAÍ;Vereador;Masculino;50;7;0;43
SÃO BENTO DO SAPUCAÍ;Vereador;Feminino;27;2;0;25
SÃO BENTO DO SUL;Vereador;Masculino;95;9;0;86
SÃO BENTO DO SUL;Vereador;Feminino;44;1;0;43
SÃO BENTO DO TOCANTINS;Vereador;Masculino;22;8;0;14
SÃO BENTO DO TOCANTINS;Vereador;Feminino;11;1;0;10
SÃO BENTO DO TRAIRÍ;Vereador;Masculino;25;8;0;17
SÃO BENTO DO TRAIRÍ;Vereador;Feminino;11;1;0;10
SÃO BENTO DO UNA;Vereador;Masculino;65;10;0;55
SÃO BENTO DO UNA;Vereador;Feminino;25;3;0;22
SÃO BERNARDINO;Vereador;Masculino;27;7;0;20
SÃO BERNARDINO;Vereador;Feminino;13;2;0;11
SÃO BERNARDO;Vereador;Masculino;37;9;0;28
SÃO BERNARDO;Vereador;Feminino;20;2;0;18
SÃO BERNARDO DO CAMPO;Vereador;Masculino;405;28;0;377
SÃO BERNARDO DO CAMPO;Vereador;Feminino;186;0;0;186
SÃO BONIFÁCIO;Vereador;Masculino;20;8;0;12
SÃO BONIFÁCIO;Vereador;Feminino;10;1;0;9
SÃO BORJA;Vereador;Masculino;71;13;0;58
SÃO BORJA;Vereador;Feminino;33;2;0;31
SÃO BRÁS;Vereador;Masculino;35;8;0;27
SÃO BRÁS;Vereador;Feminino;17;1;0;16
SÃO BRÁS DO SUAÇUÍ;Vereador;Masculino;54;8;0;46
SÃO BRÁS DO SUAÇUÍ;Vereador;Feminino;27;1;0;26
SÃO BRAZ DO PIAUÍ;Vereador;Masculino;23;8;0;15
SÃO BRAZ DO PIAUÍ;Vereador;Feminino;14;1;0;13
SÃO CAETANO DE ODIVELAS;Vereador;Masculino;41;10;0;31
SÃO CAETANO DE ODIVELAS;Vereador;Feminino;20;1;0;19
SÃO CAETANO DO SUL;Vereador;Masculino;201;18;0;183
SÃO CAETANO DO SUL;Vereador;Feminino;94;1;0;93
SÃO CAITANO;Vereador;Masculino;88;12;0;76
SÃO CAITANO;Vereador;Feminino;42;1;0;41
SÃO CARLOS;Vereador;Masculino;275;26;0;249
SÃO CARLOS;Vereador;Feminino;128;4;0;124
SÃO CARLOS DO IVAÍ;Vereador;Masculino;37;8;0;29
SÃO CARLOS DO IVAÍ;Vereador;Feminino;18;1;0;17
SÃO CRISTÓVÃO;Vereador;Masculino;177;14;0;163
SÃO CRISTÓVÃO;Vereador;Feminino;75;1;0;74
SÃO CRISTÓVÃO DO SUL;Vereador;Masculino;24;6;0;18
SÃO CRISTÓVÃO DO SUL;Vereador;Feminino;12;3;0;9
SÃO DESIDÉRIO;Vereador;Masculino;28;10;0;18
SÃO DESIDÉRIO;Vereador;Feminino;14;1;0;13
SÃO DOMINGOS;Vereador;Masculino;99;32;0;67
SÃO DOMINGOS;Vereador;Feminino;53;4;0;49
SÃO DOMINGOS DAS DORES;Vereador;Masculino;24;9;0;15
SÃO DOMINGOS DAS DORES;Vereador;Feminino;11;0;0;11
SÃO DOMINGOS DE POMBAL;Vereador;Masculino;7;6;0;1
SÃO DOMINGOS DE POMBAL;Vereador;Feminino;3;3;0;0
SÃO DOMINGOS DO ARAGUAIA;Vereador;Masculino;60;9;0;51
SÃO DOMINGOS DO ARAGUAIA;Vereador;Feminino;30;2;0;28
SÃO DOMINGOS DO AZEITÃO;Vereador;Masculino;25;8;0;17
SÃO DOMINGOS DO AZEITÃO;Vereador;Feminino;13;1;0;12
SÃO DOMINGOS DO CAPIM;Vereador;Masculino;69;9;0;60
SÃO DOMINGOS DO CAPIM;Vereador;Feminino;34;0;0;34
SÃO DOMINGOS DO CARIRI;Vereador;Masculino;24;9;0;15
SÃO DOMINGOS DO CARIRI;Vereador;Feminino;11;0;0;11
SÃO DOMINGOS DO MARANHÃO;Vereador;Masculino;29;10;0;19
SÃO DOMINGOS DO MARANHÃO;Vereador;Feminino;14;3;0;11
SÃO DOMINGOS DO NORTE;Vereador;Masculino;51;8;0;43
SÃO DOMINGOS DO NORTE;Vereador;Feminino;27;1;0;26
SÃO DOMINGOS DO PRATA;Vereador;Masculino;53;9;0;44
SÃO DOMINGOS DO PRATA;Vereador;Feminino;24;2;0;22
SÃO DOMINGOS DO SUL;Vereador;Masculino;18;7;0;11
SÃO DOMINGOS DO SUL;Vereador;Feminino;9;2;0;7
SÃO FELIPE;Vereador;Masculino;34;10;0;24
SÃO FELIPE;Vereador;Feminino;16;1;0;15
SÃO FELIPE DO OESTE;Vereador;Masculino;30;8;0;22
SÃO FELIPE DO OESTE;Vereador;Feminino;18;1;0;17
SÃO FÉLIX;Vereador;Masculino;47;7;0;40
SÃO FÉLIX;Vereador;Feminino;24;2;0;22
SÃO FÉLIX DE BALSAS;Vereador;Masculino;15;7;0;8
SÃO FÉLIX DE BALSAS;Vereador;Feminino;7;2;0;5
SÃO FÉLIX DE MINAS;Vereador;Masculino;38;9;0;29
SÃO FÉLIX DE MINAS;Vereador;Feminino;19;0;0;19
SÃO FÉLIX DO ARAGUAIA;Vereador;Masculino;29;7;0;22
SÃO FÉLIX DO ARAGUAIA;Vereador;Feminino;14;2;0;12
SÃO FÉLIX DO CORIBE;Vereador;Masculino;31;9;0;22
SÃO FÉLIX DO CORIBE;Vereador;Feminino;17;0;0;17
SÃO FÉLIX DO PIAUÍ;Vereador;Masculino;15;6;0;9
SÃO FÉLIX DO PIAUÍ;Vereador;Feminino;7;3;0;4
SÃO FÉLIX DO TOCANTINS;Vereador;Masculino;23;9;0;14
SÃO FÉLIX DO TOCANTINS;Vereador;Feminino;11;0;0;11
SÃO FÉLIX DO XINGU;Vereador;Masculino;106;15;0;91
SÃO FÉLIX DO XINGU;Vereador;Feminino;42;0;0;42
SÃO FERNANDO;Vereador;Masculino;13;7;0;6
SÃO FERNANDO;Vereador;Feminino;5;2;0;3
SÃO FIDÉLIS;Vereador;Masculino;85;13;0;72
SÃO FIDÉLIS;Vereador;Feminino;32;0;0;32
SÃO FRANCISCO;Vereador;Masculino;155;36;0;119
SÃO FRANCISCO;Vereador;Feminino;72;4;0;68
SÃO FRANCISCO DE ASSIS;Vereador;Masculino;27;10;0;17
SÃO FRANCISCO DE ASSIS;Vereador;Feminino;13;1;0;12
SÃO FRANCISCO DE ASSIS DO PIAUÍ;Vereador;Masculino;14;7;0;7
SÃO FRANCISCO DE ASSIS DO PIAUÍ;Vereador;Feminino;7;2;0;5
SÃO FRANCISCO DE GOIÁS;Vereador;Masculino;41;9;0;32
SÃO FRANCISCO DE GOIÁS;Vereador;Feminino;20;0;0;20
SÃO FRANCISCO DE ITABAPOANA;Vereador;Masculino;110;11;0;99
SÃO FRANCISCO DE ITABAPOANA;Vereador;Feminino;43;2;0;41
SÃO FRANCISCO DE PAULA;Vereador;Masculino;103;17;0;86
SÃO FRANCISCO DE PAULA;Vereador;Feminino;53;1;0;52
SÃO FRANCISCO DE SALES;Vereador;Masculino;29;6;0;23
SÃO FRANCISCO DE SALES;Vereador;Feminino;15;3;0;12
SÃO FRANCISCO DO BREJÃO;Vereador;Masculino;37;5;0;32
SÃO FRANCISCO DO BREJÃO;Vereador;Feminino;27;4;0;23
SÃO FRANCISCO DO CONDE;Vereador;Masculino;101;10;0;91
SÃO FRANCISCO DO CONDE;Vereador;Feminino;47;3;0;44
SÃO FRANCISCO DO GLÓRIA;Vereador;Masculino;27;9;0;18
SÃO FRANCISCO DO GLÓRIA;Vereador;Feminino;14;0;0;14
SÃO FRANCISCO DO GUAPORÉ;Vereador;Masculino;73;11;0;62
SÃO FRANCISCO DO GUAPORÉ;Vereador;Feminino;31;0;0;31
SÃO FRANCISCO DO MARANHÃO;Vereador;Masculino;34;7;0;27
SÃO FRANCISCO DO MARANHÃO;Vereador;Feminino;16;2;0;14
SÃO FRANCISCO DO OESTE;Vereador;Masculino;11;6;0;5
SÃO FRANCISCO DO OESTE;Vereador;Feminino;6;3;0;3
SÃO FRANCISCO DO PARÁ;Vereador;Masculino;34;8;0;26
SÃO FRANCISCO DO PARÁ;Vereador;Feminino;19;1;0;18
SÃO FRANCISCO DO PIAUÍ;Vereador;Masculino;22;9;0;13
SÃO FRANCISCO DO PIAUÍ;Vereador;Feminino;11;0;0;11
SÃO FRANCISCO DO SUL;Vereador;Masculino;82;9;0;73
SÃO FRANCISCO DO SUL;Vereador;Feminino;40;0;0;40
SÃO GABRIEL;Vereador;Masculino;141;22;0;119
SÃO GABRIEL;Vereador;Feminino;67;4;0;63
SÃO GABRIEL DA CACHOEIRA;Vereador;Masculino;67;12;0;55
SÃO GABRIEL DA CACHOEIRA;Vereador;Feminino;39;1;0;38
SÃO GABRIEL DA PALHA;Vereador;Masculino;75;9;0;66
SÃO GABRIEL DA PALHA;Vereador;Feminino;39;0;0;39
SÃO GABRIEL DO OESTE;Vereador;Masculino;64;8;0;56
SÃO GABRIEL DO OESTE;Vereador;Feminino;33;1;0;32
SÃO GERALDO;Vereador;Masculino;23;8;0;15
SÃO GERALDO;Vereador;Feminino;13;1;0;12
SÃO GERALDO DA PIEDADE;Vereador;Masculino;45;9;0;36
SÃO GERALDO DA PIEDADE;Vereador;Feminino;24;0;0;24
SÃO GERALDO DO ARAGUAIA;Vereador;Masculino;48;11;0;37
SÃO GERALDO DO ARAGUAIA;Vereador;Feminino;24;0;0;24
SÃO GERALDO DO BAIXIO;Vereador;Masculino;24;9;0;15
SÃO GERALDO DO BAIXIO;Vereador;Feminino;12;0;0;12
SÃO GONÇALO;Vereador;Masculino;516;26;0;490
SÃO GONÇALO;Vereador;Feminino;201;1;0;200
SÃO GONÇALO DO ABAETÉ;Vereador;Masculino;24;9;0;15
SÃO GONÇALO DO ABAETÉ;Vereador;Feminino;12;0;0;12
SÃO GONÇALO DO AMARANTE;Vereador;Masculino;188;27;0;161
SÃO GONÇALO DO AMARANTE;Vereador;Feminino;90;3;0;87
SÃO GONÇALO DO GURGUÉIA;Vereador;Masculino;14;9;0;5
SÃO GONÇALO DO GURGUÉIA;Vereador;Feminino;7;0;0;7
SÃO GONÇALO DO PARÁ;Vereador;Masculino;66;8;0;58
SÃO GONÇALO DO PARÁ;Vereador;Feminino;36;1;0;35
SÃO GONÇALO DO PIAUÍ;Vereador;Masculino;32;9;0;23
SÃO GONÇALO DO PIAUÍ;Vereador;Feminino;15;0;0;15
SÃO GONÇALO DO RIO ABAIXO;Vereador;Masculino;62;8;0;54
SÃO GONÇALO DO RIO ABAIXO;Vereador;Feminino;30;1;0;29
SÃO GONÇALO DO RIO PRETO;Vereador;Masculino;31;7;0;24
SÃO GONÇALO DO RIO PRETO;Vereador;Feminino;19;2;0;17
SÃO GONÇALO DO SAPUCAÍ;Vereador;Masculino;70;10;0;60
SÃO GONÇALO DO SAPUCAÍ;Vereador;Feminino;35;1;0;34
SÃO GONÇALO DOS CAMPOS;Vereador;Masculino;92;12;0;80
SÃO GONÇALO DOS CAMPOS;Vereador;Feminino;40;1;0;39
SÃO GOTARDO;Vereador;Masculino;74;12;0;62
SÃO GOTARDO;Vereador;Feminino;35;1;0;34
SÃO JERÔNIMO;Vereador;Masculino;64;10;0;54
SÃO JERÔNIMO;Vereador;Feminino;28;1;0;27
SÃO JERÔNIMO DA SERRA;Vereador;Masculino;24;9;0;15
SÃO JERÔNIMO DA SERRA;Vereador;Feminino;13;0;0;13
SÃO JOÃO;Vereador;Masculino;46;18;0;28
SÃO JOÃO;Vereador;Feminino;14;2;0;12
SÃO JOÃO BATISTA;Vereador;Masculino;104;18;0;86
SÃO JOÃO BATISTA;Vereador;Feminino;51;2;0;49
SÃO JOÃO BATISTA DO GLÓRIA;Vereador;Masculino;43;8;0;35
SÃO JOÃO BATISTA DO GLÓRIA;Vereador;Feminino;22;1;0;21
SÃO JOÃO DA BALIZA;Vereador;Masculino;57;8;0;49
SÃO JOÃO DA BALIZA;Vereador;Feminino;28;1;0;27
SÃO JOÃO DA BARRA;Vereador;Masculino;103;8;0;95
SÃO JOÃO DA BARRA;Vereador;Feminino;53;1;0;52
SÃO JOÃO DA BOA VISTA;Vereador;Masculino;143;14;0;129
SÃO JOÃO DA BOA VISTA;Vereador;Feminino;62;1;0;61
SÃO JOÃO DA CANABRAVA;Vereador;Masculino;19;8;0;11
SÃO JOÃO DA CANABRAVA;Vereador;Feminino;9;1;0;8
SÃO JOÃO DA FRONTEIRA;Vereador;Masculino;20;8;0;12
SÃO JOÃO DA FRONTEIRA;Vereador;Feminino;9;1;0;8
SÃO JOÃO DA LAGOA;Vereador;Masculino;36;8;0;28
SÃO JOÃO DA LAGOA;Vereador;Feminino;17;1;0;16
SÃO JOÃO DA MATA;Vereador;Masculino;19;5;0;14
SÃO JOÃO DA MATA;Vereador;Feminino;11;4;0;7
SÃO JOÃO DA PARAÚNA;Vereador;Masculino;20;7;0;13
SÃO JOÃO DA PARAÚNA;Vereador;Feminino;12;2;0;10
SÃO JOÃO DA PONTA;Vereador;Masculino;60;9;0;51
SÃO JOÃO DA PONTA;Vereador;Feminino;29;0;0;29
SÃO JOÃO DA PONTE;Vereador;Masculino;58;10;0;48
SÃO JOÃO DA PONTE;Vereador;Feminino;30;1;0;29
SÃO JOÃO DA SERRA;Vereador;Masculino;18;9;0;9
SÃO JOÃO DA SERRA;Vereador;Feminino;9;0;0;9
SÃO JOÃO DA URTIGA;Vereador;Masculino;15;8;0;7
SÃO JOÃO DA URTIGA;Vereador;Feminino;8;1;0;7
SÃO JOÃO DA VARJOTA;Vereador;Masculino;11;7;0;4
SÃO JOÃO DA VARJOTA;Vereador;Feminino;7;2;0;5
SÃO JOÃO D'ALIANÇA;Vereador;Masculino;54;8;0;46
SÃO JOÃO D'ALIANÇA;Vereador;Feminino;17;1;0;16
SÃO JOÃO DAS DUAS PONTES;Vereador;Masculino;14;7;0;7
SÃO JOÃO DAS DUAS PONTES;Vereador;Feminino;7;2;0;5
SÃO JOÃO DAS MISSÕES;Vereador;Masculino;27;7;0;20
SÃO JOÃO DAS MISSÕES;Vereador;Feminino;13;2;0;11
SÃO JOÃO DE IRACEMA;Vereador;Masculino;17;8;0;9
SÃO JOÃO DE IRACEMA;Vereador;Feminino;9;1;0;8
SÃO JOÃO DE MERITI;Vereador;Masculino;335;19;0;316
SÃO JOÃO DE MERITI;Vereador;Feminino;143;2;0;141
SÃO JOÃO DE PIRABAS;Vereador;Masculino;65;8;0;57
SÃO JOÃO DE PIRABAS;Vereador;Feminino;37;3;0;34
SÃO JOÃO DEL REI;Vereador;Masculino;123;10;0;113
SÃO JOÃO DEL REI;Vereador;Feminino;56;3;0;53
SÃO JOÃO DO ARAGUAIA;Vereador;Masculino;44;8;0;36
SÃO JOÃO DO ARAGUAIA;Vereador;Feminino;22;1;0;21
SÃO JOÃO DO ARRAIAL;Vereador;Masculino;21;8;0;13
SÃO JOÃO DO ARRAIAL;Vereador;Feminino;10;1;0;9
SÃO JOÃO DO CAIUÁ;Vereador;Masculino;20;8;0;12
SÃO JOÃO DO CAIUÁ;Vereador;Feminino;9;1;0;8
SÃO JOÃO DO CARIRI;Vereador;Masculino;24;9;0;15
SÃO JOÃO DO CARIRI;Vereador;Feminino;10;0;0;10
SÃO JOÃO DO CARÚ;Vereador;Masculino;36;10;0;26
SÃO JOÃO DO CARÚ;Vereador;Feminino;15;1;0;14
SÃO JOÃO DO ITAPERIÚ;Vereador;Masculino;24;7;0;17
SÃO JOÃO DO ITAPERIÚ;Vereador;Feminino;11;2;0;9
SÃO JOÃO DO IVAÍ;Vereador;Masculino;44;9;0;35
SÃO JOÃO DO IVAÍ;Vereador;Feminino;22;0;0;22
SÃO JOÃO DO JAGUARIBE;Vereador;Masculino;16;6;0;10
SÃO JOÃO DO JAGUARIBE;Vereador;Feminino;14;3;0;11
SÃO JOÃO DO MANHUAÇU;Vereador;Masculino;42;4;0;38
SÃO JOÃO DO MANHUAÇU;Vereador;Feminino;25;5;0;20
SÃO JOÃO DO MANTENINHA;Vereador;Masculino;26;8;0;18
SÃO JOÃO DO MANTENINHA;Vereador;Feminino;14;1;0;13
SÃO JOÃO DO OESTE;Vereador;Masculino;16;7;0;9
SÃO JOÃO DO OESTE;Vereador;Feminino;7;2;0;5
SÃO JOÃO DO ORIENTE;Vereador;Masculino;22;9;0;13
SÃO JOÃO DO ORIENTE;Vereador;Feminino;12;0;0;12
SÃO JOÃO DO PACUÍ;Vereador;Masculino;47;8;0;39
SÃO JOÃO DO PACUÍ;Vereador;Feminino;16;1;0;15
SÃO JOÃO DO PARAÍSO;Vereador;Masculino;111;19;0;92
SÃO JOÃO DO PARAÍSO;Vereador;Feminino;55;1;0;54
SÃO JOÃO DO PAU D'ALHO;Vereador;Masculino;19;7;0;12
SÃO JOÃO DO PAU D'ALHO;Vereador;Feminino;12;2;0;10
SÃO JOÃO DO PIAUÍ;Vereador;Masculino;32;9;0;23
SÃO JOÃO DO PIAUÍ;Vereador;Feminino;18;2;0;16
SÃO JOÃO DO POLÊSINE;Vereador;Masculino;18;7;0;11
SÃO JOÃO DO POLÊSINE;Vereador;Feminino;14;2;0;12
SÃO JOÃO DO RIO DO PEIXE;Vereador;Masculino;36;11;0;25
SÃO JOÃO DO RIO DO PEIXE;Vereador;Feminino;17;0;0;17
SÃO JOÃO DO SABUGI;Vereador;Masculino;22;9;0;13
SÃO JOÃO DO SABUGI;Vereador;Feminino;10;0;0;10
SÃO JOÃO DO SOTER;Vereador;Masculino;44;10;0;34
SÃO JOÃO DO SOTER;Vereador;Feminino;20;1;0;19
SÃO JOÃO DO SUL;Vereador;Masculino;18;8;0;10
SÃO JOÃO DO SUL;Vereador;Feminino;9;1;0;8
SÃO JOÃO DO TIGRE;Vereador;Masculino;17;6;0;11
SÃO JOÃO DO TIGRE;Vereador;Feminino;7;3;0;4
SÃO JOÃO DO TRIUNFO;Vereador;Masculino;57;9;0;48
SÃO JOÃO DO TRIUNFO;Vereador;Feminino;28;0;0;28
SÃO JOÃO DOS PATOS;Vereador;Masculino;26;11;0;15
SÃO JOÃO DOS PATOS;Vereador;Feminino;13;0;0;13
SÃO JOÃO EVANGELISTA;Vereador;Masculino;60;8;0;52
SÃO JOÃO EVANGELISTA;Vereador;Feminino;32;3;0;29
SÃO JOÃO NEPOMUCENO;Vereador;Masculino;101;9;0;92
SÃO JOÃO NEPOMUCENO;Vereador;Feminino;50;0;0;50
SÃO JOAQUIM;Vereador;Masculino;31;9;0;22
SÃO JOAQUIM;Vereador;Feminino;14;0;0;14
SÃO JOAQUIM DA BARRA;Vereador;Masculino;59;11;0;48
SÃO JOAQUIM DA BARRA;Vereador;Feminino;25;0;0;25
SÃO JOAQUIM DE BICAS;Vereador;Masculino;96;11;0;85
SÃO JOAQUIM DE BICAS;Vereador;Feminino;45;0;0;45
SÃO JOAQUIM DO MONTE;Vereador;Masculino;38;11;0;27
SÃO JOAQUIM DO MONTE;Vereador;Feminino;10;0;0;10
SÃO JORGE;Vereador;Masculino;15;7;0;8
SÃO JORGE;Vereador;Feminino;7;2;0;5
SÃO JORGE DO IVAÍ;Vereador;Masculino;24;8;0;16
SÃO JORGE DO IVAÍ;Vereador;Feminino;12;1;0;11
SÃO JORGE DO PATROCÍNIO;Vereador;Masculino;29;8;0;21
SÃO JORGE DO PATROCÍNIO;Vereador;Feminino;14;1;0;13
SÃO JORGE D'OESTE;Vereador;Masculino;18;9;0;9
SÃO JORGE D'OESTE;Vereador;Feminino;9;0;0;9
SÃO JOSÉ;Vereador;Masculino;147;11;0;136
SÃO JOSÉ;Vereador;Feminino;67;2;0;65
SÃO JOSÉ DA BARRA;Vereador;Masculino;41;8;0;33
SÃO JOSÉ DA BARRA;Vereador;Feminino;21;1;0;20
SÃO JOSÉ DA BELA VISTA;Vereador;Masculino;47;8;0;39
SÃO JOSÉ DA BELA VISTA;Vereador;Feminino;21;1;0;20
SÃO JOSÉ DA BOA VISTA;Vereador;Masculino;26;8;0;18
SÃO JOSÉ DA BOA VISTA;Vereador;Feminino;12;1;0;11
SÃO JOSÉ DA COROA GRANDE;Vereador;Masculino;75;11;0;64
SÃO JOSÉ DA COROA GRANDE;Vereador;Feminino;20;0;0;20
SÃO JOSÉ DA LAGOA TAPADA;Vereador;Masculino;20;9;0;11
SÃO JOSÉ DA LAGOA TAPADA;Vereador;Feminino;10;0;0;10
SÃO JOSÉ DA LAJE;Vereador;Masculino;48;8;0;40
SÃO JOSÉ DA LAJE;Vereador;Feminino;24;1;0;23
SÃO JOSÉ DA LAPA;Vereador;Masculino;72;8;0;64
SÃO JOSÉ DA LAPA;Vereador;Feminino;36;1;0;35
SÃO JOSÉ DA SAFIRA;Vereador;Masculino;24;8;0;16
SÃO JOSÉ DA SAFIRA;Vereador;Feminino;12;1;0;11
SÃO JOSÉ DA TAPERA;Vereador;Masculino;57;12;0;45
SÃO JOSÉ DA TAPERA;Vereador;Feminino;28;1;0;27
SÃO JOSÉ DA VARGINHA;Vereador;Masculino;40;8;0;32
SÃO JOSÉ DA VARGINHA;Vereador;Feminino;21;1;0;20
SÃO JOSÉ DA VITÓRIA;Vereador;Masculino;35;8;0;27
SÃO JOSÉ DA VITÓRIA;Vereador;Feminino;12;1;0;11
SÃO JOSÉ DAS MISSÕES;Vereador;Masculino;12;8;0;4
SÃO JOSÉ DAS MISSÕES;Vereador;Feminino;5;1;0;4
SÃO JOSÉ DAS PALMEIRAS;Vereador;Masculino;14;8;0;6
SÃO JOSÉ DAS PALMEIRAS;Vereador;Feminino;6;1;0;5
SÃO JOSÉ DE CAIANA;Vereador;Masculino;18;7;0;11
SÃO JOSÉ DE CAIANA;Vereador;Feminino;7;2;0;5
SÃO JOSÉ DE ESPINHARAS;Vereador;Masculino;18;7;0;11
SÃO JOSÉ DE ESPINHARAS;Vereador;Feminino;12;2;0;10
SÃO JOSÉ DE MIPIBU;Vereador;Masculino;42;8;0;34
SÃO JOSÉ DE MIPIBU;Vereador;Feminino;22;5;0;17
SÃO JOSÉ DE PIRANHAS;Vereador;Masculino;28;10;0;18
SÃO JOSÉ DE PIRANHAS;Vereador;Feminino;14;1;0;13
SÃO JOSÉ DE PRINCESA;Vereador;Masculino;16;8;0;8
SÃO JOSÉ DE PRINCESA;Vereador;Feminino;8;1;0;7
SÃO JOSÉ DE RIBAMAR;Vereador;Masculino;131;15;0;116
SÃO JOSÉ DE RIBAMAR;Vereador;Feminino;63;2;0;61
SÃO JOSÉ DE UBÁ;Vereador;Masculino;65;8;0;57
SÃO JOSÉ DE UBÁ;Vereador;Feminino;37;1;0;36
SÃO JOSÉ DO ALEGRE;Vereador;Masculino;29;8;0;21
SÃO JOSÉ DO ALEGRE;Vereador;Feminino;14;1;0;13
SÃO JOSÉ DO BARREIRO;Vereador;Masculino;52;9;0;43
SÃO JOSÉ DO BARREIRO;Vereador;Feminino;26;0;0;26
SÃO JOSÉ DO BELMONTE;Vereador;Masculino;33;11;0;22
SÃO JOSÉ DO BELMONTE;Vereador;Feminino;18;2;0;16
SÃO JOSÉ DO BONFIM;Vereador;Masculino;11;5;0;6
SÃO JOSÉ DO BONFIM;Vereador;Feminino;10;4;0;6
SÃO JOSÉ DO BREJO DO CRUZ;Vereador;Masculino;15;7;0;8
SÃO JOSÉ DO BREJO DO CRUZ;Vereador;Feminino;7;2;0;5
SÃO JOSÉ DO CALÇADO;Vereador;Masculino;43;9;0;34
SÃO JOSÉ DO CALÇADO;Vereador;Feminino;23;0;0;23
SÃO JOSÉ DO CAMPESTRE;Vereador;Masculino;22;7;0;15
SÃO JOSÉ DO CAMPESTRE;Vereador;Feminino;12;2;0;10
SÃO JOSÉ DO CEDRO;Vereador;Masculino;30;8;0;22
SÃO JOSÉ DO CEDRO;Vereador;Feminino;14;1;0;13
SÃO JOSÉ DO CERRITO;Vereador;Masculino;24;7;0;17
SÃO JOSÉ DO CERRITO;Vereador;Feminino;13;2;0;11
SÃO JOSÉ DO DIVINO;Vereador;Masculino;31;14;0;17
SÃO JOSÉ DO DIVINO;Vereador;Feminino;14;4;0;10
SÃO JOSÉ DO EGITO;Vereador;Masculino;44;13;0;31
SÃO JOSÉ DO EGITO;Vereador;Feminino;21;0;0;21
SÃO JOSÉ DO GOIABAL;Vereador;Masculino;35;9;0;26
SÃO JOSÉ DO GOIABAL;Vereador;Feminino;17;0;0;17
SÃO JOSÉ DO HERVAL;Vereador;Masculino;17;8;0;9
SÃO JOSÉ DO HERVAL;Vereador;Feminino;9;1;0;8
SÃO JOSÉ DO HORTÊNCIO;Vereador;Masculino;16;5;0;11
SÃO JOSÉ DO HORTÊNCIO;Vereador;Feminino;8;4;0;4
SÃO JOSÉ DO INHACORÁ;Vereador;Masculino;12;9;0;3
SÃO JOSÉ DO INHACORÁ;Vereador;Feminino;6;0;0;6
SÃO JOSÉ DO JACUÍPE;Vereador;Masculino;19;8;0;11
SÃO JOSÉ DO JACUÍPE;Vereador;Feminino;10;1;0;9
SÃO JOSÉ DO JACURI;Vereador;Masculino;44;9;0;35
SÃO JOSÉ DO JACURI;Vereador;Feminino;21;0;0;21
SÃO JOSÉ DO MANTIMENTO;Vereador;Masculino;23;9;0;14
SÃO JOSÉ DO MANTIMENTO;Vereador;Feminino;12;0;0;12
SÃO JOSÉ DO NORTE;Vereador;Masculino;49;7;0;42
SÃO JOSÉ DO NORTE;Vereador;Feminino;25;2;0;23
SÃO JOSÉ DO OURO;Vereador;Masculino;17;7;0;10
SÃO JOSÉ DO OURO;Vereador;Feminino;9;2;0;7
SÃO JOSÉ DO PEIXE;Vereador;Masculino;24;8;0;16
SÃO JOSÉ DO PEIXE;Vereador;Feminino;12;1;0;11
SÃO JOSÉ DO PIAUÍ;Vereador;Masculino;11;7;0;4
SÃO JOSÉ DO PIAUÍ;Vereador;Feminino;6;2;0;4
SÃO JOSÉ DO POVO;Vereador;Masculino;24;8;0;16
SÃO JOSÉ DO POVO;Vereador;Feminino;12;1;0;11
SÃO JOSÉ DO RIO CLARO;Vereador;Masculino;62;9;0;53
SÃO JOSÉ DO RIO CLARO;Vereador;Feminino;29;0;0;29
SÃO JOSÉ DO RIO PARDO;Vereador;Masculino;97;9;0;88
SÃO JOSÉ DO RIO PARDO;Vereador;Feminino;43;1;0;42
SÃO JOSÉ DO RIO PRETO;Vereador;Masculino;225;14;0;211
SÃO JOSÉ DO RIO PRETO;Vereador;Feminino;101;3;0;98
SÃO JOSÉ DO SABUGI;Vereador;Masculino;12;7;0;5
SÃO JOSÉ DO SABUGI;Vereador;Feminino;8;2;0;6
SÃO JOSÉ DO SERIDÓ;Vereador;Masculino;14;7;0;7
SÃO JOSÉ DO SERIDÓ;Vereador;Feminino;6;2;0;4
SÃO JOSÉ DO SUL;Vereador;Masculino;16;7;0;9
SÃO JOSÉ DO SUL;Vereador;Feminino;9;2;0;7
SÃO JOSÉ DO VALE DO RIO PRETO;Vereador;Masculino;70;7;0;63
SÃO JOSÉ DO VALE DO RIO PRETO;Vereador;Feminino;40;2;0;38
SÃO JOSÉ DO XINGU;Vereador;Masculino;32;9;0;23
SÃO JOSÉ DO XINGU;Vereador;Feminino;13;0;0;13
SÃO JOSÉ DOS AUSENTES;Vereador;Masculino;18;9;0;9
SÃO JOSÉ DOS AUSENTES;Vereador;Feminino;9;0;0;9
SÃO JOSÉ DOS BASÍLIOS;Vereador;Masculino;17;6;0;11
SÃO JOSÉ DOS BASÍLIOS;Vereador;Feminino;9;3;0;6
SÃO JOSÉ DOS CAMPOS;Vereador;Masculino;314;16;0;298
SÃO JOSÉ DOS CAMPOS;Vereador;Feminino;146;5;0;141
SÃO JOSÉ DOS CORDEIROS;Vereador;Masculino;18;8;0;10
SÃO JOSÉ DOS CORDEIROS;Vereador;Feminino;8;1;0;7
SÃO JOSÉ DOS PINHAIS;Vereador;Masculino;235;18;0;217
SÃO JOSÉ DOS PINHAIS;Vereador;Feminino;112;3;0;109
SÃO JOSÉ DOS QUATRO MARCOS;Vereador;Masculino;52;10;0;42
SÃO JOSÉ DOS QUATRO MARCOS;Vereador;Feminino;22;1;0;21
SÃO JOSÉ DOS RAMOS;Vereador;Masculino;23;7;0;16
SÃO JOSÉ DOS RAMOS;Vereador;Feminino;11;2;0;9
SÃO JULIÃO;Vereador;Masculino;17;8;0;9
SÃO JULIÃO;Vereador;Feminino;8;1;0;7
SÃO LEOPOLDO;Vereador;Masculino;117;11;0;106
SÃO LEOPOLDO;Vereador;Feminino;53;2;0;51
SÃO LOURENÇO;Vereador;Masculino;100;13;0;87
SÃO LOURENÇO;Vereador;Feminino;45;0;0;45
SÃO LOURENÇO DA MATA;Vereador;Masculino;133;14;0;119
SÃO LOURENÇO DA MATA;Vereador;Feminino;38;1;0;37
SÃO LOURENÇO DA SERRA;Vereador;Masculino;77;8;0;69
SÃO LOURENÇO DA SERRA;Vereador;Feminino;41;1;0;40
SÃO LOURENÇO DO OESTE;Vereador;Masculino;37;8;0;29
SÃO LOURENÇO DO OESTE;Vereador;Feminino;21;1;0;20
SÃO LOURENÇO DO PIAUÍ;Vereador;Masculino;15;8;0;7
SÃO LOURENÇO DO PIAUÍ;Vereador;Feminino;7;1;0;6
SÃO LOURENÇO DO SUL;Vereador;Masculino;61;8;0;53
SÃO LOURENÇO DO SUL;Vereador;Feminino;28;3;0;25
SÃO LUDGERO;Vereador;Masculino;29;9;0;20
SÃO LUDGERO;Vereador;Feminino;14;0;0;14
SÃO LUÍS;Vereador;Masculino;478;27;0;451
SÃO LUÍS;Vereador;Feminino;203;4;0;199
SÃO LUÍS DE MONTES BELOS;Vereador;Masculino;62;10;0;52
SÃO LUÍS DE MONTES BELOS;Vereador;Feminino;30;3;0;27
SÃO LUÍS DO CURU;Vereador;Masculino;45;9;0;36
SÃO LUÍS DO CURU;Vereador;Feminino;24;0;0;24
SÃO LUÍS DO PARAITINGA;Vereador;Masculino;75;8;0;67
SÃO LUÍS DO PARAITINGA;Vereador;Feminino;31;1;0;30
SÃO LUIS DO PIAUÍ;Vereador;Masculino;14;8;0;6
SÃO LUIS DO PIAUÍ;Vereador;Feminino;9;1;0;8
SÃO LUÍS DO QUITUNDE;Vereador;Masculino;85;10;0;75
SÃO LUÍS DO QUITUNDE;Vereador;Feminino;40;3;0;37
SÃO LUÍS GONZAGA DO MARANHÃO;Vereador;Masculino;52;9;0;43
SÃO LUÍS GONZAGA DO MARANHÃO;Vereador;Feminino;28;2;0;26
SÃO LUIZ;Vereador;Masculino;52;8;0;44
SÃO LUIZ;Vereador;Feminino;26;1;0;25
SÃO LUIZ DO NORTE;Vereador;Masculino;31;8;0;23
SÃO LUIZ DO NORTE;Vereador;Feminino;15;1;0;14
SÃO LUIZ GONZAGA;Vereador;Masculino;50;10;0;40
SÃO LUIZ GONZAGA;Vereador;Feminino;25;3;0;22
SÃO MAMEDE;Vereador;Masculino;23;9;0;14
SÃO MAMEDE;Vereador;Feminino;11;0;0;11
SÃO MANOEL DO PARANÁ;Vereador;Masculino;22;7;0;15
SÃO MANOEL DO PARANÁ;Vereador;Feminino;11;2;0;9
SÃO MANUEL;Vereador;Masculino;128;11;0;117
SÃO MANUEL;Vereador;Feminino;60;2;0;58
SÃO MARCOS;Vereador;Masculino;41;6;0;35
SÃO MARCOS;Vereador;Feminino;22;3;0;19
SÃO MARTINHO;Vereador;Masculino;36;16;0;20
SÃO MARTINHO;Vereador;Feminino;17;2;0;15
SÃO MARTINHO DA SERRA;Vereador;Masculino;22;8;0;14
SÃO MARTINHO DA SERRA;Vereador;Feminino;13;1;0;12
SÃO MATEUS;Vereador;Masculino;96;10;0;86
SÃO MATEUS;Vereador;Feminino;46;1;0;45
SÃO MATEUS DO MARANHÃO;Vereador;Masculino;70;11;0;59
SÃO MATEUS DO MARANHÃO;Vereador;Feminino;31;2;0;29
SÃO MATEUS DO SUL;Vereador;Masculino;82;9;0;73
SÃO MATEUS DO SUL;Vereador;Feminino;37;0;0;37
SÃO MIGUEL;Vereador;Masculino;15;7;0;8
SÃO MIGUEL;Vereador;Feminino;10;2;0;8
SÃO MIGUEL ARCANJO;Vereador;Masculino;47;10;0;37
SÃO MIGUEL ARCANJO;Vereador;Feminino;21;1;0;20
SÃO MIGUEL DA BAIXA GRANDE;Vereador;Masculino;19;7;0;12
SÃO MIGUEL DA BAIXA GRANDE;Vereador;Feminino;9;2;0;7
SÃO MIGUEL DA BOA VISTA;Vereador;Masculino;8;7;0;1
SÃO MIGUEL DA BOA VISTA;Vereador;Feminino;4;2;0;2
SÃO MIGUEL DAS MATAS;Vereador;Masculino;33;7;0;26
SÃO MIGUEL DAS MATAS;Vereador;Feminino;18;2;0;16
SÃO MIGUEL DAS MISSÕES;Vereador;Masculino;22;9;0;13
SÃO MIGUEL DAS MISSÕES;Vereador;Feminino;13;0;0;13
SÃO MIGUEL DE TAIPU;Vereador;Masculino;25;6;0;19
SÃO MIGUEL DE TAIPU;Vereador;Feminino;12;3;0;9
SÃO MIGUEL DO ALEIXO;Vereador;Masculino;22;6;0;16
SÃO MIGUEL DO ALEIXO;Vereador;Feminino;11;3;0;8
SÃO MIGUEL DO ANTA;Vereador;Masculino;51;5;0;46
SÃO MIGUEL DO ANTA;Vereador;Feminino;26;4;0;22
SÃO MIGUEL DO ARAGUAIA;Vereador;Masculino;69;10;0;59
SÃO MIGUEL DO ARAGUAIA;Vereador;Feminino;30;1;0;29
SÃO MIGUEL DO FIDALGO;Vereador;Masculino;14;8;0;6
SÃO MIGUEL DO FIDALGO;Vereador;Feminino;8;1;0;7
SÃO MIGUEL DO GOSTOSO;Vereador;Masculino;16;4;0;12
SÃO MIGUEL DO GOSTOSO;Vereador;Feminino;10;5;0;5
SÃO MIGUEL DO GUAMÁ;Vereador;Masculino;99;11;0;88
SÃO MIGUEL DO GUAMÁ;Vereador;Feminino;47;4;0;43
SÃO MIGUEL DO GUAPORÉ;Vereador;Masculino;53;10;0;43
SÃO MIGUEL DO GUAPORÉ;Vereador;Feminino;23;1;0;22
SÃO MIGUEL DO IGUAÇU;Vereador;Masculino;43;8;0;35
SÃO MIGUEL DO IGUAÇU;Vereador;Feminino;21;1;0;20
SÃO MIGUEL DO OESTE;Vereador;Masculino;51;7;0;44
SÃO MIGUEL DO OESTE;Vereador;Feminino;25;2;0;23
SÃO MIGUEL DO PASSA QUATRO;Vereador;Masculino;21;7;0;14
SÃO MIGUEL DO PASSA QUATRO;Vereador;Feminino;16;2;0;14
SÃO MIGUEL DO TAPUIO;Vereador;Masculino;28;9;0;19
SÃO MIGUEL DO TAPUIO;Vereador;Feminino;14;0;0;14
SÃO MIGUEL DO TOCANTINS;Vereador;Masculino;23;4;0;19
SÃO MIGUEL DO TOCANTINS;Vereador;Feminino;11;5;0;6
SÃO MIGUEL DOS CAMPOS;Vereador;Masculino;66;12;0;54
SÃO MIGUEL DOS CAMPOS;Vereador;Feminino;29;1;0;28
SÃO MIGUEL DOS MILAGRES;Vereador;Masculino;46;8;0;38
SÃO MIGUEL DOS MILAGRES;Vereador;Feminino;23;1;0;22
SÃO NICOLAU;Vereador;Masculino;23;8;0;15
SÃO NICOLAU;Vereador;Feminino;11;1;0;10
SÃO PATRÍCIO;Vereador;Masculino;20;7;0;13
SÃO PATRÍCIO;Vereador;Feminino;10;2;0;8
SÃO PAULO;Vereador;Masculino;817;49;0;768
SÃO PAULO;Vereador;Feminino;350;6;0;344
SÃO PAULO DAS MISSÕES;Vereador;Masculino;19;7;0;12
SÃO PAULO DAS MISSÕES;Vereador;Feminino;10;2;0;8
SÃO PAULO DE OLIVENÇA;Vereador;Masculino;63;9;0;54
SÃO PAULO DE OLIVENÇA;Vereador;Feminino;29;0;0;29
SÃO PAULO DO POTENGI;Vereador;Masculino;27;10;0;17
SÃO PAULO DO POTENGI;Vereador;Feminino;12;1;0;11
SÃO PEDRO;Vereador;Masculino;184;20;0;164
SÃO PEDRO;Vereador;Feminino;83;2;0;81
SÃO PEDRO DA ÁGUA BRANCA;Vereador;Masculino;33;6;0;27
SÃO PEDRO DA ÁGUA BRANCA;Vereador;Feminino;21;3;0;18
SÃO PEDRO DA ALDEIA;Vereador;Masculino;142;10;0;132
SÃO PEDRO DA ALDEIA;Vereador;Feminino;51;0;0;51
SÃO PEDRO DA CIPA;Vereador;Masculino;38;9;0;29
SÃO PEDRO DA CIPA;Vereador;Feminino;12;0;0;12
SÃO PEDRO DA SERRA;Vereador;Masculino;18;9;0;9
SÃO PEDRO DA SERRA;Vereador;Feminino;9;0;0;9
SÃO PEDRO DA UNIÃO;Vereador;Masculino;32;8;0;24
SÃO PEDRO DA UNIÃO;Vereador;Feminino;16;1;0;15
SÃO PEDRO DAS MISSÕES;Vereador;Masculino;15;7;0;8
SÃO PEDRO DAS MISSÕES;Vereador;Feminino;6;2;0;4
SÃO PEDRO DE ALCÂNTARA;Vereador;Masculino;28;9;0;19
SÃO PEDRO DE ALCÂNTARA;Vereador;Feminino;13;0;0;13
SÃO PEDRO DO BUTIÁ;Vereador;Masculino;16;9;0;7
SÃO PEDRO DO BUTIÁ;Vereador;Feminino;8;0;0;8
SÃO PEDRO DO IGUAÇU;Vereador;Masculino;46;9;0;37
SÃO PEDRO DO IGUAÇU;Vereador;Feminino;22;0;0;22
SÃO PEDRO DO IVAÍ;Vereador;Masculino;45;7;0;38
SÃO PEDRO DO IVAÍ;Vereador;Feminino;21;2;0;19
SÃO PEDRO DO PARANÁ;Vereador;Masculino;12;8;0;4
SÃO PEDRO DO PARANÁ;Vereador;Feminino;6;1;0;5
SÃO PEDRO DO PIAUÍ;Vereador;Masculino;32;5;0;27
SÃO PEDRO DO PIAUÍ;Vereador;Feminino;17;4;0;13
SÃO PEDRO DO SUAÇUÍ;Vereador;Masculino;33;8;0;25
SÃO PEDRO DO SUAÇUÍ;Vereador;Feminino;16;1;0;15
SÃO PEDRO DO SUL;Vereador;Masculino;39;8;0;31
SÃO PEDRO DO SUL;Vereador;Feminino;18;3;0;15
SÃO PEDRO DO TURVO;Vereador;Masculino;55;8;0;47
SÃO PEDRO DO TURVO;Vereador;Feminino;26;1;0;25
SÃO PEDRO DOS CRENTES;Vereador;Masculino;21;9;0;12
SÃO PEDRO DOS CRENTES;Vereador;Feminino;9;0;0;9
SÃO PEDRO DOS FERROS;Vereador;Masculino;52;9;0;43
SÃO PEDRO DOS FERROS;Vereador;Feminino;29;0;0;29
SÃO RAFAEL;Vereador;Masculino;30;7;0;23
SÃO RAFAEL;Vereador;Feminino;15;2;0;13
SÃO RAIMUNDO DAS MANGABEIRAS;Vereador;Masculino;54;9;0;45
SÃO RAIMUNDO DAS MANGABEIRAS;Vereador;Feminino;24;2;0;22
SÃO RAIMUNDO DO DOCA BEZERRA;Vereador;Masculino;19;7;0;12
SÃO RAIMUNDO DO DOCA BEZERRA;Vereador;Feminino;11;2;0;9
SÃO RAIMUNDO NONATO;Vereador;Masculino;46;12;0;34
SÃO RAIMUNDO NONATO;Vereador;Feminino;23;1;0;22
SÃO ROBERTO;Vereador;Masculino;16;6;0;10
SÃO ROBERTO;Vereador;Feminino;9;3;0;6
SÃO ROMÃO;Vereador;Masculino;55;7;0;48
SÃO ROMÃO;Vereador;Feminino;28;2;0;26
SÃO ROQUE;Vereador;Masculino;172;15;0;157
SÃO ROQUE;Vereador;Feminino;76;0;0;76
SÃO ROQUE DE MINAS;Vereador;Masculino;32;8;0;24
SÃO ROQUE DE MINAS;Vereador;Feminino;16;1;0;15
SÃO ROQUE DO CANAÃ;Vereador;Masculino;44;8;0;36
SÃO ROQUE DO CANAÃ;Vereador;Feminino;22;1;0;21
SÃO SALVADOR DO TOCANTINS;Vereador;Masculino;19;8;0;11
SÃO SALVADOR DO TOCANTINS;Vereador;Feminino;10;1;0;9
SÃO SEBASTIÃO;Vereador;Masculino;224;23;0;201
SÃO SEBASTIÃO;Vereador;Feminino;108;2;0;106
SÃO SEBASTIÃO DA AMOREIRA;Vereador;Masculino;22;8;0;14
SÃO SEBASTIÃO DA AMOREIRA;Vereador;Feminino;11;1;0;10
SÃO SEBASTIÃO DA BELA VISTA;Vereador;Masculino;32;9;0;23
SÃO SEBASTIÃO DA BELA VISTA;Vereador;Feminino;15;0;0;15
SÃO SEBASTIÃO DA BOA VISTA;Vereador;Masculino;53;8;0;45
SÃO SEBASTIÃO DA BOA VISTA;Vereador;Feminino;26;1;0;25
SÃO SEBASTIÃO DA GRAMA;Vereador;Masculino;39;7;0;32
SÃO SEBASTIÃO DA GRAMA;Vereador;Feminino;21;2;0;19
SÃO SEBASTIÃO DA VARGEM ALEGRE;Vereador;Masculino;21;8;0;13
SÃO SEBASTIÃO DA VARGEM ALEGRE;Vereador;Feminino;10;1;0;9
SÃO SEBASTIÃO DE LAGOA DE ROÇA;Vereador;Masculino;28;7;0;21
SÃO SEBASTIÃO DE LAGOA DE ROÇA;Vereador;Feminino;14;2;0;12
SÃO SEBASTIÃO DO ALTO;Vereador;Masculino;24;4;0;20
SÃO SEBASTIÃO DO ALTO;Vereador;Feminino;12;5;0;7
SÃO SEBASTIÃO DO ANTA;Vereador;Masculino;37;9;0;28
SÃO SEBASTIÃO DO ANTA;Vereador;Feminino;18;0;0;18
SÃO SEBASTIÃO DO CAÍ;Vereador;Masculino;52;8;0;44
SÃO SEBASTIÃO DO CAÍ;Vereador;Feminino;28;1;0;27
SÃO SEBASTIÃO DO MARANHÃO;Vereador;Masculino;36;9;0;27
SÃO SEBASTIÃO DO MARANHÃO;Vereador;Feminino;18;0;0;18
SÃO SEBASTIÃO DO OESTE;Vereador;Masculino;41;7;0;34
SÃO SEBASTIÃO DO OESTE;Vereador;Feminino;20;2;0;18
SÃO SEBASTIÃO DO PARAÍSO;Vereador;Masculino;84;9;0;75
SÃO SEBASTIÃO DO PARAÍSO;Vereador;Feminino;34;1;0;33
SÃO SEBASTIÃO DO PASSÉ;Vereador;Masculino;78;11;0;67
SÃO SEBASTIÃO DO PASSÉ;Vereador;Feminino;34;2;0;32
SÃO SEBASTIÃO DO RIO PRETO;Vereador;Masculino;20;9;0;11
SÃO SEBASTIÃO DO RIO PRETO;Vereador;Feminino;6;0;0;6
SÃO SEBASTIÃO DO RIO VERDE;Vereador;Masculino;26;7;0;19
SÃO SEBASTIÃO DO RIO VERDE;Vereador;Feminino;15;2;0;13
SÃO SEBASTIÃO DO TOCANTINS;Vereador;Masculino;29;7;0;22
SÃO SEBASTIÃO DO TOCANTINS;Vereador;Feminino;15;2;0;13
SÃO SEBASTIÃO DO UATUMÃ;Vereador;Masculino;53;8;0;45
SÃO SEBASTIÃO DO UATUMÃ;Vereador;Feminino;30;1;0;29
SÃO SEBASTIÃO DO UMBUZEIRO;Vereador;Masculino;20;6;0;14
SÃO SEBASTIÃO DO UMBUZEIRO;Vereador;Feminino;10;3;0;7
SÃO SEPÉ;Vereador;Masculino;42;11;0;31
SÃO SEPÉ;Vereador;Feminino;22;0;0;22
SÃO SIMÃO;Vereador;Masculino;130;20;0;110
SÃO SIMÃO;Vereador;Feminino;62;0;0;62
SÃO THOMÉ DAS LETRAS;Vereador;Masculino;51;9;0;42
SÃO THOMÉ DAS LETRAS;Vereador;Feminino;28;0;0;28
SÃO TIAGO;Vereador;Masculino;47;9;0;38
SÃO TIAGO;Vereador;Feminino;24;0;0;24
SÃO TOMÁS DE AQUINO;Vereador;Masculino;32;7;0;25
SÃO TOMÁS DE AQUINO;Vereador;Feminino;16;2;0;14
SÃO TOMÉ;Vereador;Masculino;66;16;0;50
SÃO TOMÉ;Vereador;Feminino;34;2;0;32
SÃO VALENTIM;Vereador;Masculino;21;9;0;12
SÃO VALENTIM;Vereador;Feminino;10;0;0;10
SÃO VALENTIM DO SUL;Vereador;Masculino;16;8;0;8
SÃO VALENTIM DO SUL;Vereador;Feminino;8;1;0;7
SÃO VALÉRIO DA NATIVIDADE;Vereador;Masculino;27;7;0;20
SÃO VALÉRIO DA NATIVIDADE;Vereador;Feminino;13;2;0;11
SÃO VALÉRIO DO SUL;Vereador;Masculino;13;7;0;6
SÃO VALÉRIO DO SUL;Vereador;Feminino;6;2;0;4
SÃO VENDELINO;Vereador;Masculino;28;7;0;21
SÃO VENDELINO;Vereador;Feminino;13;2;0;11
SÃO VICENTE;Vereador;Masculino;252;23;0;229
SÃO VICENTE;Vereador;Feminino;110;1;0;109
SÃO VICENTE DE MINAS;Vereador;Masculino;19;8;0;11
SÃO VICENTE DE MINAS;Vereador;Feminino;9;1;0;8
SÃO VICENTE DO SERIDÓ;Vereador;Masculino;44;9;0;35
SÃO VICENTE DO SERIDÓ;Vereador;Feminino;16;0;0;16
SÃO VICENTE DO SUL;Vereador;Masculino;24;9;0;15
SÃO VICENTE DO SUL;Vereador;Feminino;12;0;0;12
SÃO VICENTE FERRER;Vereador;Masculino;51;11;0;40
SÃO VICENTE FERRER;Vereador;Feminino;25;0;0;25
SÃO VICENTE FÉRRER;Vereador;Masculino;28;8;0;20
SÃO VICENTE FÉRRER;Vereador;Feminino;7;1;0;6
SAPÉ;Vereador;Masculino;92;11;0;81
SAPÉ;Vereador;Feminino;47;4;0;43
SAPEAÇU;Vereador;Masculino;49;10;0;39
SAPEAÇU;Vereador;Feminino;24;1;0;23
SAPEZAL;Vereador;Masculino;33;7;0;26
SAPEZAL;Vereador;Feminino;13;2;0;11
SAPIRANGA;Vereador;Masculino;89;13;0;76
SAPIRANGA;Vereador;Feminino;43;2;0;41
SAPOPEMA;Vereador;Masculino;23;8;0;15
SAPOPEMA;Vereador;Feminino;10;1;0;9
SAPUCAIA;Vereador;Masculino;95;14;0;81
SAPUCAIA;Vereador;Feminino;50;4;0;46
SAPUCAIA DO SUL;Vereador;Masculino;119;11;0;108
SAPUCAIA DO SUL;Vereador;Feminino;56;0;0;56
SAPUCAÍ-MIRIM;Vereador;Masculino;47;9;0;38
SAPUCAÍ-MIRIM;Vereador;Feminino;24;0;0;24
SAQUAREMA;Vereador;Masculino;116;11;0;105
SAQUAREMA;Vereador;Feminino;57;2;0;55
SARANDI;Vereador;Masculino;144;20;0;124
SARANDI;Vereador;Feminino;60;1;0;59
SARAPUÍ;Vereador;Masculino;42;7;0;35
SARAPUÍ;Vereador;Feminino;23;2;0;21
SARDOÁ;Vereador;Masculino;45;8;0;37
SARDOÁ;Vereador;Feminino;19;1;0;18
SARUTAIÁ;Vereador;Masculino;21;9;0;12
SARUTAIÁ;Vereador;Feminino;12;0;0;12
SARZEDO;Vereador;Masculino;88;9;0;79
SARZEDO;Vereador;Feminino;43;0;0;43
SÁTIRO DIAS;Vereador;Masculino;22;9;0;13
SÁTIRO DIAS;Vereador;Feminino;9;2;0;7
SATUBA;Vereador;Masculino;61;8;0;53
SATUBA;Vereador;Feminino;28;1;0;27
SATUBINHA;Vereador;Masculino;22;8;0;14
SATUBINHA;Vereador;Feminino;11;1;0;10
SAUBARA;Vereador;Masculino;75;9;0;66
SAUBARA;Vereador;Feminino;38;0;0;38
SAUDADE DO IGUAÇU;Vereador;Masculino;20;6;0;14
SAUDADE DO IGUAÇU;Vereador;Feminino;10;3;0;7
SAUDADES;Vereador;Masculino;25;7;0;18
SAUDADES;Vereador;Feminino;11;2;0;9
SAÚDE;Vereador;Masculino;30;6;0;24
SAÚDE;Vereador;Feminino;16;3;0;13
SCHROEDER;Vereador;Masculino;43;9;0;34
SCHROEDER;Vereador;Feminino;23;0;0;23
SEABRA;Vereador;Masculino;55;8;0;47
SEABRA;Vereador;Feminino;32;5;0;27
SEARA;Vereador;Masculino;21;9;0;12
SEARA;Vereador;Feminino;12;2;0;10
SEBASTIANÓPOLIS DO SUL;Vereador;Masculino;16;7;0;9
SEBASTIANÓPOLIS DO SUL;Vereador;Feminino;8;2;0;6
SEBASTIÃO BARROS;Vereador;Masculino;17;9;0;8
SEBASTIÃO BARROS;Vereador;Feminino;8;0;0;8
SEBASTIÃO LARANJEIRAS;Vereador;Masculino;22;8;0;14
SEBASTIÃO LARANJEIRAS;Vereador;Feminino;11;1;0;10
SEBASTIÃO LEAL;Vereador;Masculino;16;7;0;9
SEBASTIÃO LEAL;Vereador;Feminino;7;2;0;5
SEBERI;Vereador;Masculino;21;7;0;14
SEBERI;Vereador;Feminino;12;2;0;10
SEDE NOVA;Vereador;Masculino;17;9;0;8
SEDE NOVA;Vereador;Feminino;8;0;0;8
SEGREDO;Vereador;Masculino;24;9;0;15
SEGREDO;Vereador;Feminino;12;0;0;12
SELBACH;Vereador;Masculino;20;6;0;14
SELBACH;Vereador;Feminino;10;3;0;7
SELVÍRIA;Vereador;Masculino;40;9;0;31
SELVÍRIA;Vereador;Feminino;22;0;0;22
SEM PEIXE;Vereador;Masculino;36;8;0;28
SEM PEIXE;Vereador;Feminino;20;1;0;19
SENA MADUREIRA;Vereador;Masculino;86;12;0;74
SENA MADUREIRA;Vereador;Feminino;42;1;0;41
SENADOR ALEXANDRE COSTA;Vereador;Masculino;21;6;0;15
SENADOR ALEXANDRE COSTA;Vereador;Feminino;10;3;0;7
SENADOR AMARAL;Vereador;Masculino;20;7;0;13
SENADOR AMARAL;Vereador;Feminino;10;2;0;8
SENADOR CANEDO;Vereador;Masculino;93;12;0;81
SENADOR CANEDO;Vereador;Feminino;39;1;0;38
SENADOR CORTES;Vereador;Masculino;32;7;0;25
SENADOR CORTES;Vereador;Feminino;15;2;0;13
SENADOR ELÓI DE SOUZA;Vereador;Masculino;27;8;0;19
SENADOR ELÓI DE SOUZA;Vereador;Feminino;13;1;0;12
SENADOR FIRMINO;Vereador;Masculino;22;9;0;13
SENADOR FIRMINO;Vereador;Feminino;11;0;0;11
SENADOR GEORGINO AVELINO;Vereador;Masculino;21;5;0;16
SENADOR GEORGINO AVELINO;Vereador;Feminino;12;4;0;8
SENADOR GUIOMARD;Vereador;Masculino;68;9;0;59
SENADOR GUIOMARD;Vereador;Feminino;32;0;0;32
SENADOR JOSÉ BENTO;Vereador;Masculino;18;7;0;11
SENADOR JOSÉ BENTO;Vereador;Feminino;10;2;0;8
SENADOR JOSÉ PORFÍRIO;Vereador;Masculino;42;5;0;37
SENADOR JOSÉ PORFÍRIO;Vereador;Feminino;21;4;0;17
SENADOR LA ROCQUE;Vereador;Masculino;43;5;0;38
SENADOR LA ROCQUE;Vereador;Feminino;23;6;0;17
SENADOR MODESTINO GONÇALVES;Vereador;Masculino;29;8;0;21
SENADOR MODESTINO GONÇALVES;Vereador;Feminino;15;1;0;14
SENADOR POMPEU;Vereador;Masculino;36;8;0;28
SENADOR POMPEU;Vereador;Feminino;18;3;0;15
SENADOR RUI PALMEIRA;Vereador;Masculino;35;8;0;27
SENADOR RUI PALMEIRA;Vereador;Feminino;17;1;0;16
SENADOR SÁ;Vereador;Masculino;18;5;0;13
SENADOR SÁ;Vereador;Feminino;9;4;0;5
SENADOR SALGADO FILHO;Vereador;Masculino;22;7;0;15
SENADOR SALGADO FILHO;Vereador;Feminino;11;2;0;9
SENGÉS;Vereador;Masculino;42;9;0;33
SENGÉS;Vereador;Feminino;16;2;0;14
SENHOR DO BONFIM;Vereador;Masculino;110;12;0;98
SENHOR DO BONFIM;Vereador;Feminino;33;1;0;32
SENHORA DE OLIVEIRA;Vereador;Masculino;28;8;0;20
SENHORA DE OLIVEIRA;Vereador;Feminino;14;1;0;13
SENHORA DO PORTO;Vereador;Masculino;32;9;0;23
SENHORA DO PORTO;Vereador;Feminino;16;0;0;16
SENHORA DOS REMÉDIOS;Vereador;Masculino;56;9;0;47
SENHORA DOS REMÉDIOS;Vereador;Feminino;25;0;0;25
SENTINELA DO SUL;Vereador;Masculino;29;8;0;21
SENTINELA DO SUL;Vereador;Feminino;18;1;0;17
SENTO SÉ;Vereador;Masculino;53;11;0;42
SENTO SÉ;Vereador;Feminino;21;2;0;19
SERAFINA CORRÊA;Vereador;Masculino;20;7;0;13
SERAFINA CORRÊA;Vereador;Feminino;11;2;0;9
SERICITA;Vereador;Masculino;14;6;0;8
SERICITA;Vereador;Feminino;7;3;0;4
SERINGUEIRAS;Vereador;Masculino;61;9;0;52
SERINGUEIRAS;Vereador;Feminino;26;0;0;26
SÉRIO;Vereador;Masculino;16;7;0;9
SÉRIO;Vereador;Feminino;9;2;0;7
SERITINGA;Vereador;Masculino;30;9;0;21
SERITINGA;Vereador;Feminino;15;0;0;15
SEROPÉDICA;Vereador;Masculino;112;10;0;102
SEROPÉDICA;Vereador;Feminino;45;0;0;45
SERRA;Vereador;Masculino;335;22;0;313
SERRA;Vereador;Feminino;142;1;0;141
SERRA ALTA;Vereador;Masculino;15;9;0;6
SERRA ALTA;Vereador;Feminino;7;0;0;7
SERRA AZUL;Vereador;Masculino;52;8;0;44
SERRA AZUL;Vereador;Feminino;27;1;0;26
SERRA AZUL DE MINAS;Vereador;Masculino;22;7;0;15
SERRA AZUL DE MINAS;Vereador;Feminino;10;2;0;8
SERRA BRANCA;Vereador;Masculino;30;9;0;21
SERRA BRANCA;Vereador;Feminino;15;0;0;15
SERRA CAIADA;Vereador;Masculino;28;8;0;20
SERRA CAIADA;Vereador;Feminino;14;1;0;13
SERRA DA RAIZ;Vereador;Masculino;20;9;0;11
SERRA DA RAIZ;Vereador;Feminino;11;0;0;11
SERRA DA SAUDADE;Vereador;Masculino;12;9;0;3
SERRA DA SAUDADE;Vereador;Feminino;6;0;0;6
SERRA DE SÃO BENTO;Vereador;Masculino;19;6;0;13
SERRA DE SÃO BENTO;Vereador;Feminino;9;3;0;6
SERRA DO MEL;Vereador;Masculino;24;7;0;17
SERRA DO MEL;Vereador;Feminino;11;2;0;9
SERRA DO NAVIO;Vereador;Masculino;37;8;0;29
SERRA DO NAVIO;Vereador;Feminino;20;1;0;19
SERRA DO RAMALHO;Vereador;Masculino;64;10;0;54
SERRA DO RAMALHO;Vereador;Feminino;33;3;0;30
SERRA DO SALITRE;Vereador;Masculino;44;9;0;35
SERRA DO SALITRE;Vereador;Feminino;22;0;0;22
SERRA DOS AIMORÉS;Vereador;Masculino;37;9;0;28
SERRA DOS AIMORÉS;Vereador;Feminino;19;0;0;19
SERRA DOURADA;Vereador;Masculino;24;7;0;17
SERRA DOURADA;Vereador;Feminino;12;4;0;8
SERRA GRANDE;Vereador;Masculino;11;7;0;4
SERRA GRANDE;Vereador;Feminino;5;2;0;3
SERRA NEGRA;Vereador;Masculino;78;10;0;68
SERRA NEGRA;Vereador;Feminino;36;1;0;35
SERRA NEGRA DO NORTE;Vereador;Masculino;20;6;0;14
SERRA NEGRA DO NORTE;Vereador;Feminino;10;3;0;7
SERRA NOVA DOURADA;Vereador;Masculino;20;8;0;12
SERRA NOVA DOURADA;Vereador;Feminino;11;1;0;10
SERRA PRETA;Vereador;Masculino;46;8;0;38
SERRA PRETA;Vereador;Feminino;21;3;0;18
SERRA REDONDA;Vereador;Masculino;22;9;0;13
SERRA REDONDA;Vereador;Feminino;11;0;0;11
SERRA TALHADA;Vereador;Masculino;56;14;0;42
SERRA TALHADA;Vereador;Feminino;15;1;0;14
SERRANA;Vereador;Masculino;131;11;0;120
SERRANA;Vereador;Feminino;61;2;0;59
SERRANIA;Vereador;Masculino;35;8;0;27
SERRANIA;Vereador;Feminino;17;1;0;16
SERRANO DO MARANHÃO;Vereador;Masculino;47;8;0;39
SERRANO DO MARANHÃO;Vereador;Feminino;26;1;0;25
SERRANÓPOLIS;Vereador;Masculino;22;6;0;16
SERRANÓPOLIS;Vereador;Feminino;12;3;0;9
SERRANÓPOLIS DE MINAS;Vereador;Masculino;27;8;0;19
SERRANÓPOLIS DE MINAS;Vereador;Feminino;15;1;0;14
SERRANÓPOLIS DO IGUAÇU;Vereador;Masculino;19;8;0;11
SERRANÓPOLIS DO IGUAÇU;Vereador;Feminino;16;1;0;15
SERRANOS;Vereador;Masculino;33;8;0;25
SERRANOS;Vereador;Feminino;17;1;0;16
SERRARIA;Vereador;Masculino;19;8;0;11
SERRARIA;Vereador;Feminino;10;1;0;9
SERRINHA;Vereador;Masculino;123;19;0;104
SERRINHA;Vereador;Feminino;66;5;0;61
SERRINHA DOS PINTOS;Vereador;Masculino;14;6;0;8
SERRINHA DOS PINTOS;Vereador;Feminino;7;3;0;4
SERRITA;Vereador;Masculino;27;10;0;17
SERRITA;Vereador;Feminino;4;1;0;3
SERRO;Vereador;Masculino;55;9;0;46
SERRO;Vereador;Feminino;28;0;0;28
SERROLÂNDIA;Vereador;Masculino;23;6;0;17
SERROLÂNDIA;Vereador;Feminino;11;3;0;8
SERTANEJA;Vereador;Masculino;23;5;0;18
SERTANEJA;Vereador;Feminino;14;4;0;10
SERTÂNIA;Vereador;Masculino;52;12;0;40
SERTÂNIA;Vereador;Feminino;22;1;0;21
SERTANÓPOLIS;Vereador;Masculino;80;8;0;72
SERTANÓPOLIS;Vereador;Feminino;42;1;0;41
SERTÃO;Vereador;Masculino;16;9;0;7
SERTÃO;Vereador;Feminino;8;0;0;8
SERTÃO SANTANA;Vereador;Masculino;26;8;0;18
SERTÃO SANTANA;Vereador;Feminino;16;1;0;15
SERTÃOZINHO;Vereador;Masculino;242;23;0;219
SERTÃOZINHO;Vereador;Feminino;117;3;0;114
SETE BARRAS;Vereador;Masculino;83;7;0;76
SETE BARRAS;Vereador;Feminino;40;2;0;38
SETE DE SETEMBRO;Vereador;Masculino;13;7;0;6
SETE DE SETEMBRO;Vereador;Feminino;7;2;0;5
SETE LAGOAS;Vereador;Masculino;188;16;0;172
SETE LAGOAS;Vereador;Feminino;84;1;0;83
SETE QUEDAS;Vereador;Masculino;41;7;0;34
SETE QUEDAS;Vereador;Feminino;20;2;0;18
SETUBINHA;Vereador;Masculino;50;8;0;42
SETUBINHA;Vereador;Feminino;25;1;0;24
SEVERIANO DE ALMEIDA;Vereador;Masculino;19;8;0;11
SEVERIANO DE ALMEIDA;Vereador;Feminino;10;1;0;9
SEVERIANO MELO;Vereador;Masculino;16;8;0;8
SEVERIANO MELO;Vereador;Feminino;8;1;0;7
SEVERÍNIA;Vereador;Masculino;48;10;0;38
SEVERÍNIA;Vereador;Feminino;23;1;0;22
SIDERÓPOLIS;Vereador;Masculino;31;9;0;22
SIDERÓPOLIS;Vereador;Feminino;16;0;0;16
SIDROLÂNDIA;Vereador;Masculino;88;11;0;77
SIDROLÂNDIA;Vereador;Feminino;50;2;0;48
SIGEFREDO PACHECO;Vereador;Masculino;24;8;0;16
SIGEFREDO PACHECO;Vereador;Feminino;12;1;0;11
SILVA JARDIM;Vereador;Masculino;59;7;0;52
SILVA JARDIM;Vereador;Feminino;33;2;0;31
SILVÂNIA;Vereador;Masculino;61;10;0;51
SILVÂNIA;Vereador;Feminino;31;1;0;30
SILVANÓPOLIS;Vereador;Masculino;24;8;0;16
SILVANÓPOLIS;Vereador;Feminino;12;1;0;11
SILVEIRA MARTINS;Vereador;Masculino;20;7;0;13
SILVEIRA MARTINS;Vereador;Feminino;10;2;0;8
SILVEIRÂNIA;Vereador;Masculino;21;9;0;12
SILVEIRÂNIA;Vereador;Feminino;9;0;0;9
SILVEIRAS;Vereador;Masculino;35;9;0;26
SILVEIRAS;Vereador;Feminino;16;0;0;16
SILVES;Vereador;Masculino;45;9;0;36
SILVES;Vereador;Feminino;25;0;0;25
SILVIANÓPOLIS;Vereador;Masculino;38;4;0;34
SILVIANÓPOLIS;Vereador;Feminino;17;5;0;12
SIMÃO DIAS;Vereador;Masculino;64;11;0;53
SIMÃO DIAS;Vereador;Feminino;31;2;0;29
SIMÃO PEREIRA;Vereador;Masculino;41;9;0;32
SIMÃO PEREIRA;Vereador;Feminino;21;0;0;21
SIMÕES;Vereador;Masculino;20;8;0;12
SIMÕES;Vereador;Feminino;8;1;0;7
SIMÕES FILHO;Vereador;Masculino;192;14;0;178
SIMÕES FILHO;Vereador;Feminino;79;3;0;76
SIMOLÂNDIA;Vereador;Masculino;43;8;0;35
SIMOLÂNDIA;Vereador;Feminino;21;1;0;20
SIMONÉSIA;Vereador;Masculino;62;10;0;52
SIMONÉSIA;Vereador;Feminino;34;1;0;33
SIMPLÍCIO MENDES;Vereador;Masculino;29;9;0;20
SIMPLÍCIO MENDES;Vereador;Feminino;15;0;0;15
SINIMBU;Vereador;Masculino;39;8;0;31
SINIMBU;Vereador;Feminino;19;1;0;18
SINOP;Vereador;Masculino;106;15;0;91
SINOP;Vereador;Feminino;44;0;0;44
SIQUEIRA CAMPOS;Vereador;Masculino;71;9;0;62
SIQUEIRA CAMPOS;Vereador;Feminino;32;0;0;32
SIRINHAÉM;Vereador;Masculino;54;11;0;43
SIRINHAÉM;Vereador;Feminino;24;0;0;24
SIRIRI;Vereador;Masculino;36;7;0;29
SIRIRI;Vereador;Feminino;18;2;0;16
SÍTIO D'ABADIA;Vereador;Masculino;21;7;0;14
SÍTIO D'ABADIA;Vereador;Feminino;11;2;0;9
SÍTIO DO MATO;Vereador;Masculino;54;6;0;48
SÍTIO DO MATO;Vereador;Feminino;21;3;0;18
SÍTIO DO QUINTO;Vereador;Masculino;25;8;0;17
SÍTIO DO QUINTO;Vereador;Feminino;14;1;0;13
SÍTIO NOVO;Vereador;Masculino;47;11;0;36
SÍTIO NOVO;Vereador;Feminino;23;9;0;14
SÍTIO NOVO DO TOCANTINS;Vereador;Masculino;34;6;0;28
SÍTIO NOVO DO TOCANTINS;Vereador;Feminino;18;3;0;15
SOBRADINHO;Vereador;Masculino;102;19;0;83
SOBRADINHO;Vereador;Feminino;51;1;0;50
SOBRADO;Vereador;Masculino;33;9;0;24
SOBRADO;Vereador;Feminino;17;0;0;17
SOBRAL;Vereador;Masculino;138;19;0;119
SOBRAL;Vereador;Feminino;61;2;0;59
SOBRÁLIA;Vereador;Masculino;70;7;0;63
SOBRÁLIA;Vereador;Feminino;36;2;0;34
SOCORRO;Vereador;Masculino;39;8;0;31
SOCORRO;Vereador;Feminino;18;1;0;17
SOCORRO DO PIAUÍ;Vereador;Masculino;28;8;0;20
SOCORRO DO PIAUÍ;Vereador;Feminino;14;1;0;13
SOLÂNEA;Vereador;Masculino;28;9;0;19
SOLÂNEA;Vereador;Feminino;12;2;0;10
SOLEDADE;Vereador;Masculino;106;18;0;88
SOLEDADE;Vereador;Feminino;51;4;0;47
SOLEDADE DE MINAS;Vereador;Masculino;58;9;0;49
SOLEDADE DE MINAS;Vereador;Feminino;29;0;0;29
SOLIDÃO;Vereador;Masculino;11;8;0;3
SOLIDÃO;Vereador;Feminino;7;1;0;6
SOLONÓPOLE;Vereador;Masculino;40;11;0;29
SOLONÓPOLE;Vereador;Feminino;18;0;0;18
SOMBRIO;Vereador;Masculino;35;11;0;24
SOMBRIO;Vereador;Feminino;16;0;0;16
SONORA;Vereador;Masculino;49;11;0;38
SONORA;Vereador;Feminino;28;0;0;28
SOORETAMA;Vereador;Masculino;68;9;0;59
SOORETAMA;Vereador;Feminino;33;0;0;33
SOROCABA;Vereador;Masculino;305;20;0;285
SOROCABA;Vereador;Feminino;134;0;0;134
SORRISO;Vereador;Masculino;95;9;0;86
SORRISO;Vereador;Feminino;43;2;0;41
SOSSÊGO;Vereador;Masculino;17;7;0;10
SOSSÊGO;Vereador;Feminino;9;2;0;7
SOURE;Vereador;Masculino;61;7;0;54
SOURE;Vereador;Feminino;31;2;0;29
SOUSA;Vereador;Masculino;65;13;0;52
SOUSA;Vereador;Feminino;24;0;0;24
SOUTO SOARES;Vereador;Masculino;29;11;0;18
SOUTO SOARES;Vereador;Feminino;13;0;0;13
SUCUPIRA;Vereador;Masculino;24;5;0;19
SUCUPIRA;Vereador;Feminino;15;4;0;11
SUCUPIRA DO NORTE;Vereador;Masculino;20;8;0;12
SUCUPIRA DO NORTE;Vereador;Feminino;9;1;0;8
SUCUPIRA DO RIACHÃO;Vereador;Masculino;23;7;0;16
SUCUPIRA DO RIACHÃO;Vereador;Feminino;11;2;0;9
SUD MENNUCCI;Vereador;Masculino;29;8;0;21
SUD MENNUCCI;Vereador;Feminino;14;1;0;13
SUL BRASIL;Vereador;Masculino;21;8;0;13
SUL BRASIL;Vereador;Feminino;11;1;0;10
SULINA;Vereador;Masculino;27;7;0;20
SULINA;Vereador;Feminino;13;2;0;11
SUMARÉ;Vereador;Masculino;247;21;0;226
SUMARÉ;Vereador;Feminino;118;0;0;118
SUMÉ;Vereador;Masculino;37;9;0;28
SUMÉ;Vereador;Feminino;18;2;0;16
SUMIDOURO;Vereador;Masculino;41;8;0;33
SUMIDOURO;Vereador;Feminino;18;1;0;17
SURUBIM;Vereador;Masculino;74;10;0;64
SURUBIM;Vereador;Feminino;29;1;0;28
SUSSUAPARA;Vereador;Masculino;22;9;0;13
SUSSUAPARA;Vereador;Feminino;12;0;0;12
SUZANÁPOLIS;Vereador;Masculino;29;8;0;21
SUZANÁPOLIS;Vereador;Feminino;15;1;0;14
SUZANO;Vereador;Masculino;351;19;0;332
SUZANO;Vereador;Feminino;150;2;0;148
TABAÍ;Vereador;Masculino;31;8;0;23
TABAÍ;Vereador;Feminino;15;1;0;14
TABAPORÃ;Vereador;Masculino;32;7;0;25
TABAPORÃ;Vereador;Feminino;10;2;0;8
TABAPUÃ;Vereador;Masculino;52;8;0;44
TABAPUÃ;Vereador;Feminino;26;1;0;25
TABATINGA;Vereador;Masculino;147;19;0;128
TABATINGA;Vereador;Feminino;74;5;0;69
TABIRA;Vereador;Masculino;37;10;0;27
TABIRA;Vereador;Feminino;15;1;0;14
TABOÃO DA SERRA;Vereador;Masculino;150;10;0;140
TABOÃO DA SERRA;Vereador;Feminino;67;3;0;64
TABOCAS DO BREJO VELHO;Vereador;Masculino;30;9;0;21
TABOCAS DO BREJO VELHO;Vereador;Feminino;10;0;0;10
TABOLEIRO GRANDE;Vereador;Masculino;15;7;0;8
TABOLEIRO GRANDE;Vereador;Feminino;10;2;0;8
TABULEIRO;Vereador;Masculino;36;9;0;27
TABULEIRO;Vereador;Feminino;20;0;0;20
TABULEIRO DO NORTE;Vereador;Masculino;35;9;0;26
TABULEIRO DO NORTE;Vereador;Feminino;17;2;0;15
TACAIMBÓ;Vereador;Masculino;31;5;0;26
TACAIMBÓ;Vereador;Feminino;15;4;0;11
TACARATU;Vereador;Masculino;35;11;0;24
TACARATU;Vereador;Feminino;15;0;0;15
TACIBA;Vereador;Masculino;20;5;0;15
TACIBA;Vereador;Feminino;12;4;0;8
TACIMA;Vereador;Masculino;18;8;0;10
TACIMA;Vereador;Feminino;9;1;0;8
TACURU;Vereador;Masculino;53;9;0;44
TACURU;Vereador;Feminino;24;0;0;24
TAGUAÍ;Vereador;Masculino;38;6;0;32
TAGUAÍ;Vereador;Feminino;18;3;0;15
TAGUATINGA;Vereador;Masculino;42;9;0;33
TAGUATINGA;Vereador;Feminino;21;0;0;21
TAIAÇU;Vereador;Masculino;43;6;0;37
TAIAÇU;Vereador;Feminino;25;3;0;22
TAILÂNDIA;Vereador;Masculino;104;9;0;95
TAILÂNDIA;Vereador;Feminino;49;4;0;45
TAIÓ;Vereador;Masculino;41;5;0;36
TAIÓ;Vereador;Feminino;21;4;0;17
TAIOBEIRAS;Vereador;Masculino;57;13;0;44
TAIOBEIRAS;Vereador;Feminino;25;0;0;25
TAIPAS DO TOCANTINS;Vereador;Masculino;25;5;0;20
TAIPAS DO TOCANTINS;Vereador;Feminino;11;4;0;7
TAIPU;Vereador;Masculino;30;7;0;23
TAIPU;Vereador;Feminino;17;2;0;15
TAIÚVA;Vereador;Masculino;40;6;0;34
TAIÚVA;Vereador;Feminino;20;3;0;17
TALISMÃ;Vereador;Masculino;28;9;0;19
TALISMÃ;Vereador;Feminino;16;0;0;16
TAMANDARÉ;Vereador;Masculino;51;11;0;40
TAMANDARÉ;Vereador;Feminino;20;0;0;20
TAMARANA;Vereador;Masculino;60;9;0;51
TAMARANA;Vereador;Feminino;21;0;0;21
TAMBAÚ;Vereador;Masculino;81;11;0;70
TAMBAÚ;Vereador;Feminino;38;0;0;38
TAMBOARA;Vereador;Masculino;43;9;0;34
TAMBOARA;Vereador;Feminino;21;0;0;21
TAMBORIL;Vereador;Masculino;23;9;0;14
TAMBORIL;Vereador;Feminino;14;2;0;12
TAMBORIL DO PIAUÍ;Vereador;Masculino;19;9;0;10
TAMBORIL DO PIAUÍ;Vereador;Feminino;8;0;0;8
TANABI;Vereador;Masculino;44;11;0;33
TANABI;Vereador;Feminino;18;0;0;18
TANGARÁ;Vereador;Masculino;48;11;0;37
TANGARÁ;Vereador;Feminino;28;7;0;21
TANGARÁ DA SERRA;Vereador;Masculino;124;12;0;112
TANGARÁ DA SERRA;Vereador;Feminino;59;2;0;57
TANGUÁ;Vereador;Masculino;121;13;0;108
TANGUÁ;Vereador;Feminino;55;0;0;55
TANHAÇU;Vereador;Masculino;29;11;0;18
TANHAÇU;Vereador;Feminino;14;0;0;14
TANQUE D'ARCA;Vereador;Masculino;29;6;0;23
TANQUE D'ARCA;Vereador;Feminino;16;3;0;13
TANQUE DO PIAUÍ;Vereador;Masculino;17;7;0;10
TANQUE DO PIAUÍ;Vereador;Feminino;8;2;0;6
TANQUE NOVO;Vereador;Masculino;26;9;0;17
TANQUE NOVO;Vereador;Feminino;13;2;0;11
TANQUINHO;Vereador;Masculino;54;7;0;47
TANQUINHO;Vereador;Feminino;25;2;0;23
TAPARUBA;Vereador;Masculino;28;8;0;20
TAPARUBA;Vereador;Feminino;14;1;0;13
TAPAUÁ;Vereador;Masculino;74;10;0;64
TAPAUÁ;Vereador;Feminino;38;1;0;37
TAPEJARA;Vereador;Masculino;79;18;0;61
TAPEJARA;Vereador;Feminino;28;2;0;26
TAPERA;Vereador;Masculino;33;9;0;24
TAPERA;Vereador;Feminino;18;0;0;18
TAPEROÁ;Vereador;Masculino;68;13;0;55
TAPEROÁ;Vereador;Feminino;33;7;0;26
TAPES;Vereador;Masculino;48;7;0;41
TAPES;Vereador;Feminino;21;2;0;19
TAPIRA;Vereador;Masculino;71;14;0;57
TAPIRA;Vereador;Feminino;36;4;0;32
TAPIRAÍ;Vereador;Masculino;72;18;0;54
TAPIRAÍ;Vereador;Feminino;40;0;0;40
TAPIRAMUTÁ;Vereador;Masculino;41;9;0;32
TAPIRAMUTÁ;Vereador;Feminino;19;2;0;17
TAPIRATIBA;Vereador;Masculino;67;7;0;60
TAPIRATIBA;Vereador;Feminino;38;2;0;36
TAPURAH;Vereador;Masculino;43;8;0;35
TAPURAH;Vereador;Feminino;21;1;0;20
TAQUARA;Vereador;Masculino;82;13;0;69
TAQUARA;Vereador;Feminino;43;2;0;41
TAQUARAÇU DE MINAS;Vereador;Masculino;42;7;0;35
TAQUARAÇU DE MINAS;Vereador;Feminino;19;2;0;17
TAQUARAL;Vereador;Masculino;35;7;0;28
TAQUARAL;Vereador;Feminino;19;2;0;17
TAQUARAL DE GOIÁS;Vereador;Masculino;55;8;0;47
TAQUARAL DE GOIÁS;Vereador;Feminino;27;1;0;26
TAQUARANA;Vereador;Masculino;41;10;0;31
TAQUARANA;Vereador;Feminino;20;1;0;19
TAQUARI;Vereador;Masculino;47;9;0;38
TAQUARI;Vereador;Feminino;25;0;0;25
TAQUARITINGA;Vereador;Masculino;78;12;0;66
TAQUARITINGA;Vereador;Feminino;36;1;0;35
TAQUARITINGA DO NORTE;Vereador;Masculino;30;9;0;21
TAQUARITINGA DO NORTE;Vereador;Feminino;4;2;0;2
TAQUARITUBA;Vereador;Masculino;72;9;0;63
TAQUARITUBA;Vereador;Feminino;30;2;0;28
TAQUARIVAÍ;Vereador;Masculino;35;8;0;27
TAQUARIVAÍ;Vereador;Feminino;18;1;0;17
TAQUARUÇU DO SUL;Vereador;Masculino;8;6;0;2
TAQUARUÇU DO SUL;Vereador;Feminino;5;3;0;2
TAQUARUSSU;Vereador;Masculino;16;7;0;9
TAQUARUSSU;Vereador;Feminino;8;2;0;6
TARABAI;Vereador;Masculino;56;9;0;47
TARABAI;Vereador;Feminino;26;0;0;26
TARAUACÁ;Vereador;Masculino;58;10;0;48
TARAUACÁ;Vereador;Feminino;27;1;0;26
TARRAFAS;Vereador;Masculino;18;8;0;10
TARRAFAS;Vereador;Feminino;9;1;0;8
TARTARUGALZINHO;Vereador;Masculino;44;8;0;36
TARTARUGALZINHO;Vereador;Feminino;20;1;0;19
TARUMÃ;Vereador;Masculino;59;8;0;51
TARUMÃ;Vereador;Feminino;30;1;0;29
TARUMIRIM;Vereador;Masculino;33;8;0;25
TARUMIRIM;Vereador;Feminino;17;1;0;16
TASSO FRAGOSO;Vereador;Masculino;29;9;0;20
TASSO FRAGOSO;Vereador;Feminino;15;0;0;15
TATUÍ;Vereador;Masculino;121;16;0;105
TATUÍ;Vereador;Feminino;55;1;0;54
TAUÁ;Vereador;Masculino;30;12;0;18
TAUÁ;Vereador;Feminino;14;3;0;11
TAUBATÉ;Vereador;Masculino;212;15;0;197
TAUBATÉ;Vereador;Feminino;88;4;0;84
TAVARES;Vereador;Masculino;47;12;0;35
TAVARES;Vereador;Feminino;24;6;0;18
TEFÉ;Vereador;Masculino;81;13;0;68
TEFÉ;Vereador;Feminino;33;2;0;31
TEIXEIRA;Vereador;Masculino;35;9;0;26
TEIXEIRA;Vereador;Feminino;13;0;0;13
TEIXEIRA DE FREITAS;Vereador;Masculino;152;17;0;135
TEIXEIRA DE FREITAS;Vereador;Feminino;70;2;0;68
TEIXEIRA SOARES;Vereador;Masculino;45;7;0;38
TEIXEIRA SOARES;Vereador;Feminino;18;2;0;16
TEIXEIRAS;Vereador;Masculino;46;6;0;40
TEIXEIRAS;Vereador;Feminino;23;3;0;20
TEIXEIRÓPOLIS;Vereador;Masculino;22;8;0;14
TEIXEIRÓPOLIS;Vereador;Feminino;9;1;0;8
TEJUÇUOCA;Vereador;Masculino;30;9;0;21
TEJUÇUOCA;Vereador;Feminino;15;2;0;13
TEJUPÁ;Vereador;Masculino;31;9;0;22
TEJUPÁ;Vereador;Feminino;15;0;0;15
TELÊMACO BORBA;Vereador;Masculino;143;11;0;132
TELÊMACO BORBA;Vereador;Feminino;61;2;0;59
TELHA;Vereador;Masculino;22;8;0;14
TELHA;Vereador;Feminino;11;1;0;10
TENENTE ANANIAS;Vereador;Masculino;20;6;0;14
TENENTE ANANIAS;Vereador;Feminino;11;3;0;8
TENENTE LAURENTINO CRUZ;Vereador;Masculino;21;6;0;15
TENENTE LAURENTINO CRUZ;Vereador;Feminino;10;3;0;7
TENENTE PORTELA;Vereador;Masculino;19;6;0;13
TENENTE PORTELA;Vereador;Feminino;9;3;0;6
TENÓRIO;Vereador;Masculino;22;9;0;13
TENÓRIO;Vereador;Feminino;12;0;0;12
TEODORO SAMPAIO;Vereador;Masculino;116;19;0;97
TEODORO SAMPAIO;Vereador;Feminino;60;1;0;59
TEOFILÂNDIA;Vereador;Masculino;43;10;0;33
TEOFILÂNDIA;Vereador;Feminino;20;1;0;19
TEÓFILO OTONI;Vereador;Masculino;194;17;0;177
TEÓFILO OTONI;Vereador;Feminino;82;2;0;80
TEOLÂNDIA;Vereador;Masculino;34;8;0;26
TEOLÂNDIA;Vereador;Feminino;16;1;0;15
TEOTÔNIO VILELA;Vereador;Masculino;59;11;0;48
TEOTÔNIO VILELA;Vereador;Feminino;23;2;0;21
TERENOS;Vereador;Masculino;41;11;0;30
TERENOS;Vereador;Feminino;18;0;0;18
TERESINA;Vereador;Masculino;398;23;0;375
TERESINA;Vereador;Feminino;173;6;0;167
TERESINA DE GOIÁS;Vereador;Masculino;34;8;0;26
TERESINA DE GOIÁS;Vereador;Feminino;11;1;0;10
TERESÓPOLIS;Vereador;Masculino;176;12;0;164
TERESÓPOLIS;Vereador;Feminino;78;0;0;78
TEREZINHA;Vereador;Masculino;21;9;0;12
TEREZINHA;Vereador;Feminino;4;0;0;4
TEREZÓPOLIS DE GOIÁS;Vereador;Masculino;59;7;0;52
TEREZÓPOLIS DE GOIÁS;Vereador;Feminino;30;2;0;28
TERRA ALTA;Vereador;Masculino;54;7;0;47
TERRA ALTA;Vereador;Feminino;29;2;0;27
TERRA BOA;Vereador;Masculino;23;7;0;16
TERRA BOA;Vereador;Feminino;8;2;0;6
TERRA DE AREIA;Vereador;Masculino;31;9;0;22
TERRA DE AREIA;Vereador;Feminino;15;0;0;15
TERRA NOVA;Vereador;Masculino;88;17;0;71
TERRA NOVA;Vereador;Feminino;41;1;0;40
TERRA NOVA DO NORTE;Vereador;Masculino;51;8;0;43
TERRA NOVA DO NORTE;Vereador;Feminino;21;1;0;20
TERRA RICA;Vereador;Masculino;32;7;0;25
TERRA RICA;Vereador;Feminino;16;2;0;14
TERRA ROXA;Vereador;Masculino;69;20;0;49
TERRA ROXA;Vereador;Feminino;35;0;0;35
TERRA SANTA;Vereador;Masculino;30;11;0;19
TERRA SANTA;Vereador;Feminino;14;0;0;14
TESOURO;Vereador;Masculino;15;9;0;6
TESOURO;Vereador;Feminino;6;0;0;6
TEUTÔNIA;Vereador;Masculino;42;10;0;32
TEUTÔNIA;Vereador;Feminino;20;1;0;19
THEOBROMA;Vereador;Masculino;33;8;0;25
THEOBROMA;Vereador;Feminino;11;1;0;10
TIANGUÁ;Vereador;Masculino;51;12;0;39
TIANGUÁ;Vereador;Feminino;26;3;0;23
TIBAGI;Vereador;Masculino;44;7;0;37
TIBAGI;Vereador;Feminino;23;2;0;21
TIBAU;Vereador;Masculino;21;8;0;13
TIBAU;Vereador;Feminino;10;1;0;9
TIBAU DO SUL;Vereador;Masculino;34;9;0;25
TIBAU DO SUL;Vereador;Feminino;18;0;0;18
TIETÊ;Vereador;Masculino;100;7;0;93
TIETÊ;Vereador;Feminino;54;2;0;52
TIGRINHOS;Vereador;Masculino;15;8;0;7
TIGRINHOS;Vereador;Feminino;7;1;0;6
TIJUCAS;Vereador;Masculino;37;11;0;26
TIJUCAS;Vereador;Feminino;17;2;0;15
TIJUCAS DO SUL;Vereador;Masculino;61;8;0;53
TIJUCAS DO SUL;Vereador;Feminino;30;1;0;29
TIMBAÚBA;Vereador;Masculino;57;12;0;45
TIMBAÚBA;Vereador;Feminino;23;1;0;22
TIMBAÚBA DOS BATISTAS;Vereador;Masculino;19;7;0;12
TIMBAÚBA DOS BATISTAS;Vereador;Feminino;9;2;0;7
TIMBÉ DO SUL;Vereador;Masculino;17;8;0;9
TIMBÉ DO SUL;Vereador;Feminino;8;1;0;7
TIMBIRAS;Vereador;Masculino;72;11;0;61
TIMBIRAS;Vereador;Feminino;31;0;0;31
TIMBÓ;Vereador;Masculino;49;9;0;40
TIMBÓ;Vereador;Feminino;24;0;0;24
TIMBÓ GRANDE;Vereador;Masculino;36;8;0;28
TIMBÓ GRANDE;Vereador;Feminino;19;1;0;18
TIMBURI;Vereador;Masculino;22;9;0;13
TIMBURI;Vereador;Feminino;12;0;0;12
TIMON;Vereador;Masculino;197;18;0;179
TIMON;Vereador;Feminino;82;1;0;81
TIMÓTEO;Vereador;Masculino;133;13;0;120
TIMÓTEO;Vereador;Feminino;55;2;0;53
TIO HUGO;Vereador;Masculino;19;8;0;11
TIO HUGO;Vereador;Feminino;9;1;0;8
TIRADENTES;Vereador;Masculino;44;9;0;35
TIRADENTES;Vereador;Feminino;22;0;0;22
TIRADENTES DO SUL;Vereador;Masculino;25;8;0;17
TIRADENTES DO SUL;Vereador;Feminino;9;1;0;8
TIROS;Vereador;Masculino;26;9;0;17
TIROS;Vereador;Feminino;14;0;0;14
TOBIAS BARRETO;Vereador;Masculino;59;13;0;46
TOBIAS BARRETO;Vereador;Feminino;28;0;0;28
TOCANTÍNIA;Vereador;Masculino;42;9;0;33
TOCANTÍNIA;Vereador;Feminino;5;0;0;5
TOCANTINÓPOLIS;Vereador;Masculino;38;10;0;28
TOCANTINÓPOLIS;Vereador;Feminino;18;1;0;17
TOCANTINS;Vereador;Masculino;47;9;0;38
TOCANTINS;Vereador;Feminino;24;2;0;22
TOCOS DO MOJI;Vereador;Masculino;23;8;0;15
TOCOS DO MOJI;Vereador;Feminino;12;1;0;11
TOLEDO;Vereador;Masculino;199;26;0;173
TOLEDO;Vereador;Feminino;89;2;0;87
TOMAR DO GERU;Vereador;Masculino;32;8;0;24
TOMAR DO GERU;Vereador;Feminino;15;1;0;14
TOMAZINA;Vereador;Masculino;27;9;0;18
TOMAZINA;Vereador;Feminino;13;0;0;13
TOMBOS;Vereador;Masculino;31;7;0;24
TOMBOS;Vereador;Feminino;18;2;0;16
TOMÉ-AÇU;Vereador;Masculino;95;13;0;82
TOMÉ-AÇU;Vereador;Feminino;47;2;0;45
TONANTINS;Vereador;Masculino;44;9;0;35
TONANTINS;Vereador;Feminino;21;2;0;19
TORITAMA;Vereador;Masculino;69;12;0;57
TORITAMA;Vereador;Feminino;13;1;0;12
TORIXORÉU;Vereador;Masculino;19;7;0;12
TORIXORÉU;Vereador;Feminino;9;2;0;7
TOROPI;Vereador;Masculino;23;8;0;15
TOROPI;Vereador;Feminino;11;1;0;10
TORRE DE PEDRA;Vereador;Masculino;22;7;0;15
TORRE DE PEDRA;Vereador;Feminino;12;2;0;10
TORRES;Vereador;Masculino;75;11;0;64
TORRES;Vereador;Feminino;35;2;0;33
TORRINHA;Vereador;Masculino;42;9;0;33
TORRINHA;Vereador;Feminino;19;0;0;19
TOUROS;Vereador;Masculino;53;10;0;43
TOUROS;Vereador;Feminino;26;3;0;23
TRABIJU;Vereador;Masculino;21;7;0;14
TRABIJU;Vereador;Feminino;11;2;0;9
TRACUATEUA;Vereador;Masculino;52;10;0;42
TRACUATEUA;Vereador;Feminino;22;1;0;21
TRACUNHAÉM;Vereador;Masculino;61;8;0;53
TRACUNHAÉM;Vereador;Feminino;24;1;0;23
TRAIPU;Vereador;Masculino;34;8;0;26
TRAIPU;Vereador;Feminino;19;3;0;16
TRAIRÃO;Vereador;Masculino;49;9;0;40
TRAIRÃO;Vereador;Feminino;22;2;0;20
TRAIRI;Vereador;Masculino;67;11;0;56
TRAIRI;Vereador;Feminino;34;4;0;30
TRAJANO DE MORAIS;Vereador;Masculino;43;9;0;34
TRAJANO DE MORAIS;Vereador;Feminino;21;0;0;21
TRAMANDAÍ;Vereador;Masculino;60;11;0;49
TRAMANDAÍ;Vereador;Feminino;33;2;0;31
TRAVESSEIRO;Vereador;Masculino;15;8;0;7
TRAVESSEIRO;Vereador;Feminino;8;1;0;7
TREMEDAL;Vereador;Masculino;30;9;0;21
TREMEDAL;Vereador;Feminino;14;2;0;12
TREMEMBÉ;Vereador;Masculino;102;9;0;93
TREMEMBÉ;Vereador;Feminino;49;0;0;49
TRÊS ARROIOS;Vereador;Masculino;20;8;0;12
TRÊS ARROIOS;Vereador;Feminino;10;1;0;9
TRÊS BARRAS;Vereador;Masculino;87;7;0;80
TRÊS BARRAS;Vereador;Feminino;44;4;0;40
TRÊS BARRAS DO PARANÁ;Vereador;Masculino;20;9;0;11
TRÊS BARRAS DO PARANÁ;Vereador;Feminino;9;0;0;9
TRÊS CACHOEIRAS;Vereador;Masculino;22;8;0;14
TRÊS CACHOEIRAS;Vereador;Feminino;11;1;0;10
TRÊS CORAÇÕES;Vereador;Masculino;111;7;0;104
TRÊS CORAÇÕES;Vereador;Feminino;49;3;0;46
TRÊS COROAS;Vereador;Masculino;38;8;0;30
TRÊS COROAS;Vereador;Feminino;18;1;0;17
TRÊS DE MAIO;Vereador;Masculino;26;11;0;15
TRÊS DE MAIO;Vereador;Feminino;14;0;0;14
TRÊS FORQUILHAS;Vereador;Masculino;24;8;0;16
TRÊS FORQUILHAS;Vereador;Feminino;13;1;0;12
TRÊS FRONTEIRAS;Vereador;Masculino;29;6;0;23
TRÊS FRONTEIRAS;Vereador;Feminino;15;3;0;12
TRÊS LAGOAS;Vereador;Masculino;129;14;0;115
TRÊS LAGOAS;Vereador;Feminino;56;3;0;53
TRÊS MARIAS;Vereador;Masculino;60;9;0;51
TRÊS MARIAS;Vereador;Feminino;28;2;0;26
TRÊS PALMEIRAS;Vereador;Masculino;21;8;0;13
TRÊS PALMEIRAS;Vereador;Feminino;8;1;0;7
TRÊS PASSOS;Vereador;Masculino;36;10;0;26
TRÊS PASSOS;Vereador;Feminino;17;1;0;16
TRÊS PONTAS;Vereador;Masculino;146;13;0;133
TRÊS PONTAS;Vereador;Feminino;66;2;0;64
TRÊS RANCHOS;Vereador;Masculino;24;8;0;16
TRÊS RANCHOS;Vereador;Feminino;12;1;0;11
TRÊS RIOS;Vereador;Masculino;135;12;0;123
TRÊS RIOS;Vereador;Feminino;60;1;0;59
TREVISO;Vereador;Masculino;18;7;0;11
TREVISO;Vereador;Feminino;10;2;0;8
TREZE DE MAIO;Vereador;Masculino;21;9;0;12
TREZE DE MAIO;Vereador;Feminino;10;0;0;10
TREZE TÍLIAS;Vereador;Masculino;18;8;0;10
TREZE TÍLIAS;Vereador;Feminino;8;1;0;7
TRINDADE;Vereador;Masculino;216;24;0;192
TRINDADE;Vereador;Feminino;95;4;0;91
TRINDADE DO SUL;Vereador;Masculino;19;9;0;10
TRINDADE DO SUL;Vereador;Feminino;9;0;0;9
TRIUNFO;Vereador;Masculino;88;25;0;63
TRIUNFO;Vereador;Feminino;47;6;0;41
TRIUNFO POTIGUAR;Vereador;Masculino;20;9;0;11
TRIUNFO POTIGUAR;Vereador;Feminino;10;0;0;10
TRIZIDELA DO VALE;Vereador;Masculino;54;9;0;45
TRIZIDELA DO VALE;Vereador;Feminino;26;2;0;24
TROMBAS;Vereador;Masculino;24;9;0;15
TROMBAS;Vereador;Feminino;9;0;0;9
TROMBUDO CENTRAL;Vereador;Masculino;22;8;0;14
TROMBUDO CENTRAL;Vereador;Feminino;11;1;0;10
TUBARÃO;Vereador;Masculino;148;17;0;131
TUBARÃO;Vereador;Feminino;57;0;0;57
TUCANO;Vereador;Masculino;64;10;0;54
TUCANO;Vereador;Feminino;30;5;0;25
TUCUMÃ;Vereador;Masculino;66;13;0;53
TUCUMÃ;Vereador;Feminino;33;0;0;33
TUCUNDUVA;Vereador;Masculino;19;9;0;10
TUCUNDUVA;Vereador;Feminino;9;0;0;9
TUCURUÍ;Vereador;Masculino;133;13;0;120
TUCURUÍ;Vereador;Feminino;58;0;0;58
TUFILÂNDIA;Vereador;Masculino;28;8;0;20
TUFILÂNDIA;Vereador;Feminino;17;1;0;16
TUIUTI;Vereador;Masculino;50;8;0;42
TUIUTI;Vereador;Feminino;26;1;0;25
TUMIRITINGA;Vereador;Masculino;33;7;0;26
TUMIRITINGA;Vereador;Feminino;19;2;0;17
TUNÁPOLIS;Vereador;Masculino;18;6;0;12
TUNÁPOLIS;Vereador;Feminino;8;3;0;5
TUNAS;Vereador;Masculino;24;8;0;16
TUNAS;Vereador;Feminino;4;1;0;3
TUNAS DO PARANÁ;Vereador;Masculino;41;8;0;33
TUNAS DO PARANÁ;Vereador;Feminino;19;1;0;18
TUNEIRAS DO OESTE;Vereador;Masculino;43;7;0;36
TUNEIRAS DO OESTE;Vereador;Feminino;15;2;0;13
TUNTUM;Vereador;Masculino;22;11;0;11
TUNTUM;Vereador;Feminino;10;2;0;8
TUPÃ;Vereador;Masculino;102;14;0;88
TUPÃ;Vereador;Feminino;44;1;0;43
TUPACIGUARA;Vereador;Masculino;67;9;0;58
TUPACIGUARA;Vereador;Feminino;33;0;0;33
TUPANATINGA;Vereador;Masculino;26;9;0;17
TUPANATINGA;Vereador;Feminino;8;2;0;6
TUPANCI DO SUL;Vereador;Masculino;14;7;0;7
TUPANCI DO SUL;Vereador;Feminino;6;2;0;4
TUPANCIRETÃ;Vereador;Masculino;46;7;0;39
TUPANCIRETÃ;Vereador;Feminino;25;2;0;23
TUPANDI;Vereador;Masculino;17;7;0;10
TUPANDI;Vereador;Feminino;8;2;0;6
TUPARENDI;Vereador;Masculino;21;7;0;14
TUPARENDI;Vereador;Feminino;11;2;0;9
TUPARETAMA;Vereador;Masculino;16;9;0;7
TUPARETAMA;Vereador;Feminino;8;0;0;8
TUPÃSSI;Vereador;Masculino;24;8;0;16
TUPÃSSI;Vereador;Feminino;10;1;0;9
TUPI PAULISTA;Vereador;Masculino;32;6;0;26
TUPI PAULISTA;Vereador;Feminino;22;3;0;19
TUPIRAMA;Vereador;Masculino;20;6;0;14
TUPIRAMA;Vereador;Feminino;9;3;0;6
TUPIRATINS;Vereador;Masculino;20;7;0;13
TUPIRATINS;Vereador;Feminino;9;2;0;7
TURIAÇU;Vereador;Masculino;117;12;0;105
TURIAÇU;Vereador;Feminino;54;1;0;53
TURILÂNDIA;Vereador;Masculino;70;9;0;61
TURILÂNDIA;Vereador;Feminino;28;2;0;26
TURIÚBA;Vereador;Masculino;16;7;0;9
TURIÚBA;Vereador;Feminino;10;2;0;8
TURMALINA;Vereador;Masculino;74;20;0;54
TURMALINA;Vereador;Feminino;37;0;0;37
TURUÇU;Vereador;Masculino;33;8;0;25
TURUÇU;Vereador;Feminino;19;1;0;18
TURURU;Vereador;Masculino;40;9;0;31
TURURU;Vereador;Feminino;20;0;0;20
TURVÂNIA;Vereador;Masculino;42;8;0;34
TURVÂNIA;Vereador;Feminino;22;1;0;21
TURVELÂNDIA;Vereador;Masculino;22;9;0;13
TURVELÂNDIA;Vereador;Feminino;10;0;0;10
TURVO;Vereador;Masculino;73;15;0;58
TURVO;Vereador;Feminino;20;3;0;17
TURVOLÂNDIA;Vereador;Masculino;35;8;0;27
TURVOLÂNDIA;Vereador;Feminino;18;1;0;17
TUTÓIA;Vereador;Masculino;93;12;0;81
TUTÓIA;Vereador;Feminino;43;1;0;42
UARINI;Vereador;Masculino;57;8;0;49
UARINI;Vereador;Feminino;25;1;0;24
UAUÁ;Vereador;Masculino;55;10;0;45
UAUÁ;Vereador;Feminino;24;1;0;23
UBÁ;Vereador;Masculino;96;10;0;86
UBÁ;Vereador;Feminino;42;1;0;41
UBAÍ;Vereador;Masculino;30;9;0;21
UBAÍ;Vereador;Feminino;13;0;0;13
UBAÍRA;Vereador;Masculino;53;8;0;45
UBAÍRA;Vereador;Feminino;26;3;0;23
UBAITABA;Vereador;Masculino;55;10;0;45
UBAITABA;Vereador;Feminino;24;1;0;23
UBAJARA;Vereador;Masculino;29;9;0;20
UBAJARA;Vereador;Feminino;14;0;0;14
UBAPORANGA;Vereador;Masculino;47;9;0;38
UBAPORANGA;Vereador;Feminino;23;0;0;23
UBARANA;Vereador;Masculino;44;8;0;36
UBARANA;Vereador;Feminino;21;1;0;20
UBATÃ;Vereador;Masculino;59;10;0;49
UBATÃ;Vereador;Feminino;25;1;0;24
UBATUBA;Vereador;Masculino;158;8;0;150
UBATUBA;Vereador;Feminino;76;2;0;74
UBERABA;Vereador;Masculino;164;14;0;150
UBERABA;Vereador;Feminino;79;0;0;79
UBERLÂNDIA;Vereador;Masculino;439;23;0;416
UBERLÂNDIA;Vereador;Feminino;202;4;0;198
UBIRAJARA;Vereador;Masculino;45;6;0;39
UBIRAJARA;Vereador;Feminino;25;3;0;22
UBIRATÃ;Vereador;Masculino;46;7;0;39
UBIRATÃ;Vereador;Feminino;21;2;0;19
UBIRETAMA;Vereador;Masculino;17;8;0;9
UBIRETAMA;Vereador;Feminino;10;1;0;9
UCHOA;Vereador;Masculino;36;9;0;27
UCHOA;Vereador;Feminino;18;0;0;18
UIBAÍ;Vereador;Masculino;22;7;0;15
UIBAÍ;Vereador;Feminino;11;2;0;9
UIRAMUTÃ;Vereador;Masculino;27;7;0;20
UIRAMUTÃ;Vereador;Feminino;12;2;0;10
UIRAPURU;Vereador;Masculino;26;6;0;20
UIRAPURU;Vereador;Feminino;11;3;0;8
UIRAÚNA;Vereador;Masculino;17;8;0;9
UIRAÚNA;Vereador;Feminino;9;1;0;8
ULIANÓPOLIS;Vereador;Masculino;20;6;0;14
ULIANÓPOLIS;Vereador;Feminino;10;3;0;7
UMARI;Vereador;Masculino;23;8;0;15
UMARI;Vereador;Feminino;12;1;0;11
UMARIZAL;Vereador;Masculino;24;8;0;16
UMARIZAL;Vereador;Feminino;11;1;0;10
UMBAÚBA;Vereador;Masculino;58;9;0;49
UMBAÚBA;Vereador;Feminino;28;2;0;26
UMBURANAS;Vereador;Masculino;41;10;0;31
UMBURANAS;Vereador;Feminino;13;1;0;12
UMBURATIBA;Vereador;Masculino;22;9;0;13
UMBURATIBA;Vereador;Feminino;12;0;0;12
UMBUZEIRO;Vereador;Masculino;25;8;0;17
UMBUZEIRO;Vereador;Feminino;12;1;0;11
UMIRIM;Vereador;Masculino;48;10;0;38
UMIRIM;Vereador;Feminino;20;1;0;19
UMUARAMA;Vereador;Masculino;97;10;0;87
UMUARAMA;Vereador;Feminino;40;0;0;40
UNA;Vereador;Masculino;80;10;0;70
UNA;Vereador;Feminino;39;1;0;38
UNAÍ;Vereador;Masculino;143;12;0;131
UNAÍ;Vereador;Feminino;67;3;0;64
UNIÃO;Vereador;Masculino;57;12;0;45
UNIÃO;Vereador;Feminino;27;1;0;26
UNIÃO DA SERRA;Vereador;Masculino;20;8;0;12
UNIÃO DA SERRA;Vereador;Feminino;11;1;0;10
UNIÃO DA VITÓRIA;Vereador;Masculino;66;13;0;53
UNIÃO DA VITÓRIA;Vereador;Feminino;26;0;0;26
UNIÃO DE MINAS;Vereador;Masculino;23;8;0;15
UNIÃO DE MINAS;Vereador;Feminino;12;1;0;11
UNIÃO DO OESTE;Vereador;Masculino;28;8;0;20
UNIÃO DO OESTE;Vereador;Feminino;14;1;0;13
UNIÃO DO SUL;Vereador;Masculino;19;9;0;10
UNIÃO DO SUL;Vereador;Feminino;10;0;0;10
UNIÃO DOS PALMARES;Vereador;Masculino;99;15;0;84
UNIÃO DOS PALMARES;Vereador;Feminino;45;0;0;45
UNIÃO PAULISTA;Vereador;Masculino;24;6;0;18
UNIÃO PAULISTA;Vereador;Feminino;12;3;0;9
UNIFLOR;Vereador;Masculino;23;8;0;15
UNIFLOR;Vereador;Feminino;11;1;0;10
UNISTALDA;Vereador;Masculino;19;7;0;12
UNISTALDA;Vereador;Feminino;9;2;0;7
UPANEMA;Vereador;Masculino;18;8;0;10
UPANEMA;Vereador;Feminino;9;1;0;8
URAÍ;Vereador;Masculino;48;7;0;41
URAÍ;Vereador;Feminino;28;2;0;26
URANDI;Vereador;Masculino;31;9;0;22
URANDI;Vereador;Feminino;15;2;0;13
URÂNIA;Vereador;Masculino;40;8;0;32
URÂNIA;Vereador;Feminino;25;1;0;24
URBANO SANTOS;Vereador;Masculino;42;8;0;34
URBANO SANTOS;Vereador;Feminino;26;3;0;23
URU;Vereador;Masculino;21;8;0;13
URU;Vereador;Feminino;9;1;0;8
URUAÇU;Vereador;Masculino;88;12;0;76
URUAÇU;Vereador;Feminino;38;1;0;37
URUANA;Vereador;Masculino;51;9;0;42
URUANA;Vereador;Feminino;22;0;0;22
URUANA DE MINAS;Vereador;Masculino;36;8;0;28
URUANA DE MINAS;Vereador;Feminino;19;1;0;18
URUARÁ;Vereador;Masculino;88;13;0;75
URUARÁ;Vereador;Feminino;36;0;0;36
URUBICI;Vereador;Masculino;24;7;0;17
URUBICI;Vereador;Feminino;13;2;0;11
URUBURETAMA;Vereador;Masculino;29;8;0;21
URUBURETAMA;Vereador;Feminino;17;3;0;14
URUCÂNIA;Vereador;Masculino;42;6;0;36
URUCÂNIA;Vereador;Feminino;23;3;0;20
URUCARÁ;Vereador;Masculino;48;9;0;39
URUCARÁ;Vereador;Feminino;24;2;0;22
URUÇUCA;Vereador;Masculino;65;7;0;58
URUÇUCA;Vereador;Feminino;31;4;0;27
URUÇUÍ;Vereador;Masculino;43;6;0;37
URUÇUÍ;Vereador;Feminino;23;5;0;18
URUCUIA;Vereador;Masculino;40;9;0;31
URUCUIA;Vereador;Feminino;23;0;0;23
URUCURITUBA;Vereador;Masculino;89;11;0;78
URUCURITUBA;Vereador;Feminino;42;0;0;42
URUGUAIANA;Vereador;Masculino;79;9;0;70
URUGUAIANA;Vereador;Feminino;38;2;0;36
URUOCA;Vereador;Masculino;20;7;0;13
URUOCA;Vereador;Feminino;14;2;0;12
URUPÁ;Vereador;Masculino;59;8;0;51
URUPÁ;Vereador;Feminino;28;1;0;27
URUPEMA;Vereador;Masculino;16;7;0;9
URUPEMA;Vereador;Feminino;7;2;0;5
URUPÊS;Vereador;Masculino;27;7;0;20
URUPÊS;Vereador;Feminino;13;2;0;11
URUSSANGA;Vereador;Masculino;41;6;0;35
URUSSANGA;Vereador;Feminino;23;3;0;20
URUTAÍ;Vereador;Masculino;29;6;0;23
URUTAÍ;Vereador;Feminino;16;3;0;13
UTINGA;Vereador;Masculino;37;11;0;26
UTINGA;Vereador;Feminino;20;0;0;20
VACARIA;Vereador;Masculino;92;13;0;79
VACARIA;Vereador;Feminino;44;2;0;42
VALE DE SÃO DOMINGOS;Vereador;Masculino;17;7;0;10
VALE DE SÃO DOMINGOS;Vereador;Feminino;9;2;0;7
VALE DO ANARI;Vereador;Masculino;40;9;0;31
VALE DO ANARI;Vereador;Feminino;18;0;0;18
VALE DO PARAÍSO;Vereador;Masculino;34;8;0;26
VALE DO PARAÍSO;Vereador;Feminino;15;1;0;14
VALE DO SOL;Vereador;Masculino;37;9;0;28
VALE DO SOL;Vereador;Feminino;18;0;0;18
VALE REAL;Vereador;Masculino;28;7;0;21
VALE REAL;Vereador;Feminino;14;2;0;12
VALE VERDE;Vereador;Masculino;26;8;0;18
VALE VERDE;Vereador;Feminino;13;1;0;12
VALENÇA;Vereador;Masculino;237;25;0;212
VALENÇA;Vereador;Feminino;101;2;0;99
VALENÇA DO PIAUÍ;Vereador;Masculino;25;8;0;17
VALENÇA DO PIAUÍ;Vereador;Feminino;14;3;0;11
VALENTE;Vereador;Masculino;27;10;0;17
VALENTE;Vereador;Feminino;13;1;0;12
VALENTIM GENTIL;Vereador;Masculino;39;9;0;30
VALENTIM GENTIL;Vereador;Feminino;20;0;0;20
VALINHOS;Vereador;Masculino;193;17;0;176
VALINHOS;Vereador;Feminino;89;0;0;89
VALPARAÍSO;Vereador;Masculino;58;10;0;48
VALPARAÍSO;Vereador;Feminino;26;1;0;25
VALPARAÍSO DE GOIÁS;Vereador;Masculino;148;12;0;136
VALPARAÍSO DE GOIÁS;Vereador;Feminino;66;1;0;65
VANINI;Vereador;Masculino;13;6;0;7
VANINI;Vereador;Feminino;8;3;0;5
VARGEÃO;Vereador;Masculino;9;7;0;2
VARGEÃO;Vereador;Feminino;5;2;0;3
VARGEM;Vereador;Masculino;96;18;0;78
VARGEM;Vereador;Feminino;46;0;0;46
VARGEM ALEGRE;Vereador;Masculino;40;8;0;32
VARGEM ALEGRE;Vereador;Feminino;20;1;0;19
VARGEM ALTA;Vereador;Masculino;72;10;0;62
VARGEM ALTA;Vereador;Feminino;36;1;0;35
VARGEM BONITA;Vereador;Masculino;33;15;0;18
VARGEM BONITA;Vereador;Feminino;18;3;0;15
VARGEM GRANDE;Vereador;Masculino;63;12;0;51
VARGEM GRANDE;Vereador;Feminino;27;1;0;26
VARGEM GRANDE DO RIO PARDO;Vereador;Masculino;18;9;0;9
VARGEM GRANDE DO RIO PARDO;Vereador;Feminino;9;0;0;9
VARGEM GRANDE DO SUL;Vereador;Masculino;57;12;0;45
VARGEM GRANDE DO SUL;Vereador;Feminino;25;1;0;24
VARGEM GRANDE PAULISTA;Vereador;Masculino;78;9;0;69
VARGEM GRANDE PAULISTA;Vereador;Feminino;41;0;0;41
VARGINHA;Vereador;Masculino;154;14;0;140
VARGINHA;Vereador;Feminino;60;1;0;59
VARJÃO;Vereador;Masculino;26;9;0;17
VARJÃO;Vereador;Feminino;14;0;0;14
VARJÃO DE MINAS;Vereador;Masculino;34;8;0;26
VARJÃO DE MINAS;Vereador;Feminino;16;1;0;15
VARJOTA;Vereador;Masculino;18;9;0;9
VARJOTA;Vereador;Feminino;10;2;0;8
VARRE-SAI;Vereador;Masculino;52;7;0;45
VARRE-SAI;Vereador;Feminino;28;2;0;26
VÁRZEA;Vereador;Masculino;49;13;0;36
VÁRZEA;Vereador;Feminino;25;5;0;20
VÁRZEA ALEGRE;Vereador;Masculino;25;11;0;14
VÁRZEA ALEGRE;Vereador;Feminino;12;2;0;10
VÁRZEA BRANCA;Vereador;Masculino;22;9;0;13
VÁRZEA BRANCA;Vereador;Feminino;12;0;0;12
VÁRZEA DA PALMA;Vereador;Masculino;129;13;0;116
VÁRZEA DA PALMA;Vereador;Feminino;60;0;0;60
VÁRZEA DA ROÇA;Vereador;Masculino;28;9;0;19
VÁRZEA DA ROÇA;Vereador;Feminino;14;0;0;14
VÁRZEA DO POÇO;Vereador;Masculino;18;6;0;12
VÁRZEA DO POÇO;Vereador;Feminino;12;3;0;9
VÁRZEA GRANDE;Vereador;Masculino;258;27;0;231
VÁRZEA GRANDE;Vereador;Feminino;108;3;0;105
VÁRZEA NOVA;Vereador;Masculino;25;8;0;17
VÁRZEA NOVA;Vereador;Feminino;12;1;0;11
VÁRZEA PAULISTA;Vereador;Masculino;134;9;0;125
VÁRZEA PAULISTA;Vereador;Feminino;62;2;0;60
VARZEDO;Vereador;Masculino;30;8;0;22
VARZEDO;Vereador;Feminino;16;1;0;15
VARZELÂNDIA;Vereador;Masculino;48;10;0;38
VARZELÂNDIA;Vereador;Feminino;24;1;0;23
VASSOURAS;Vereador;Masculino;119;9;0;110
VASSOURAS;Vereador;Feminino;59;4;0;55
VAZANTE;Vereador;Masculino;68;10;0;58
VAZANTE;Vereador;Feminino;31;1;0;30
VENÂNCIO AIRES;Vereador;Masculino;100;12;0;88
VENÂNCIO AIRES;Vereador;Feminino;44;3;0;41
VENDA NOVA DO IMIGRANTE;Vereador;Masculino;45;9;0;36
VENDA NOVA DO IMIGRANTE;Vereador;Feminino;22;0;0;22
VENHA-VER;Vereador;Masculino;13;5;0;8
VENHA-VER;Vereador;Feminino;9;4;0;5
VENTANIA;Vereador;Masculino;42;7;0;35
VENTANIA;Vereador;Feminino;22;2;0;20
VENTUROSA;Vereador;Masculino;39;11;0;28
VENTUROSA;Vereador;Feminino;21;0;0;21
VERA;Vereador;Masculino;27;9;0;18
VERA;Vereador;Feminino;15;0;0;15
VERA CRUZ;Vereador;Masculino;226;37;0;189
VERA CRUZ;Vereador;Feminino;103;3;0;100
VERA CRUZ DO OESTE;Vereador;Masculino;45;7;0;38
VERA CRUZ DO OESTE;Vereador;Feminino;13;2;0;11
VERA MENDES;Vereador;Masculino;12;6;0;6
VERA MENDES;Vereador;Feminino;6;3;0;3
VERANÓPOLIS;Vereador;Masculino;50;8;0;42
VERANÓPOLIS;Vereador;Feminino;24;1;0;23
VERDEJANTE;Vereador;Masculino;34;8;0;26
VERDEJANTE;Vereador;Feminino;18;1;0;17
VERDELÂNDIA;Vereador;Masculino;47;9;0;38
VERDELÂNDIA;Vereador;Feminino;22;0;0;22
VERÊ;Vereador;Masculino;20;9;0;11
VERÊ;Vereador;Feminino;4;0;0;4
VEREDA;Vereador;Masculino;25;8;0;17
VEREDA;Vereador;Feminino;9;1;0;8
VEREDINHA;Vereador;Masculino;21;8;0;13
VEREDINHA;Vereador;Feminino;11;1;0;10
VERÍSSIMO;Vereador;Masculino;23;9;0;14
VERÍSSIMO;Vereador;Feminino;13;0;0;13
VERMELHO NOVO;Vereador;Masculino;44;7;0;37
VERMELHO NOVO;Vereador;Feminino;23;2;0;21
VERTENTE DO LÉRIO;Vereador;Masculino;21;7;0;14
VERTENTE DO LÉRIO;Vereador;Feminino;10;2;0;8
VERTENTES;Vereador;Masculino;21;7;0;14
VERTENTES;Vereador;Feminino;9;2;0;7
VESPASIANO;Vereador;Masculino;179;13;0;166
VESPASIANO;Vereador;Feminino;77;2;0;75
VESPASIANO CORRÊA;Vereador;Masculino;18;6;0;12
VESPASIANO CORRÊA;Vereador;Feminino;10;3;0;7
VIADUTOS;Vereador;Masculino;19;9;0;10
VIADUTOS;Vereador;Feminino;9;0;0;9
VIAMÃO;Vereador;Masculino;187;20;0;167
VIAMÃO;Vereador;Feminino;82;1;0;81
VIANA;Vereador;Masculino;155;20;0;135
VIANA;Vereador;Feminino;70;4;0;66
VIANÓPOLIS;Vereador;Masculino;49;8;0;41
VIANÓPOLIS;Vereador;Feminino;32;1;0;31
VICÊNCIA;Vereador;Masculino;70;11;0;59
VICÊNCIA;Vereador;Feminino;15;0;0;15
VICENTE DUTRA;Vereador;Masculino;23;9;0;14
VICENTE DUTRA;Vereador;Feminino;11;0;0;11
VICENTINA;Vereador;Masculino;30;8;0;22
VICENTINA;Vereador;Feminino;9;1;0;8
VICENTINÓPOLIS;Vereador;Masculino;24;8;0;16
VICENTINÓPOLIS;Vereador;Feminino;12;1;0;11
VIÇOSA;Vereador;Masculino;203;30;0;173
VIÇOSA;Vereador;Feminino;90;5;0;85
VIÇOSA DO CEARÁ;Vereador;Masculino;30;12;0;18
VIÇOSA DO CEARÁ;Vereador;Feminino;13;1;0;12
VICTOR GRAEFF;Vereador;Masculino;18;8;0;10
VICTOR GRAEFF;Vereador;Feminino;9;1;0;8
VIDAL RAMOS;Vereador;Masculino;23;9;0;14
VIDAL RAMOS;Vereador;Feminino;12;0;0;12
VIDEIRA;Vereador;Masculino;41;8;0;33
VIDEIRA;Vereador;Feminino;20;3;0;17
VIEIRAS;Vereador;Masculino;23;9;0;14
VIEIRAS;Vereador;Feminino;11;0;0;11
VIEIRÓPOLIS;Vereador;Masculino;22;8;0;14
VIEIRÓPOLIS;Vereador;Feminino;13;1;0;12
VIGIA;Vereador;Masculino;91;13;0;78
VIGIA;Vereador;Feminino;33;0;0;33
VILA BELA DA SANTÍSSIMA TRINDADE;Vereador;Masculino;59;8;0;51
VILA BELA DA SANTÍSSIMA TRINDADE;Vereador;Feminino;28;1;0;27
VILA BOA;Vereador;Masculino;37;7;0;30
VILA BOA;Vereador;Feminino;18;2;0;16
VILA FLOR;Vereador;Masculino;29;7;0;22
VILA FLOR;Vereador;Feminino;17;2;0;15
VILA FLORES;Vereador;Masculino;23;7;0;16
VILA FLORES;Vereador;Feminino;12;2;0;10
VILA LÂNGARO;Vereador;Masculino;11;6;0;5
VILA LÂNGARO;Vereador;Feminino;6;3;0;3
VILA MARIA;Vereador;Masculino;20;6;0;14
VILA MARIA;Vereador;Feminino;10;3;0;7
VILA NOVA DO PIAUÍ;Vereador;Masculino;15;7;0;8
VILA NOVA DO PIAUÍ;Vereador;Feminino;8;2;0;6
VILA NOVA DO SUL;Vereador;Masculino;21;6;0;15
VILA NOVA DO SUL;Vereador;Feminino;10;3;0;7
VILA NOVA DOS MARTÍRIOS;Vereador;Masculino;38;8;0;30
VILA NOVA DOS MARTÍRIOS;Vereador;Feminino;22;1;0;21
VILA PAVÃO;Vereador;Masculino;54;8;0;46
VILA PAVÃO;Vereador;Feminino;27;1;0;26
VILA PROPÍCIO;Vereador;Masculino;40;8;0;32
VILA PROPÍCIO;Vereador;Feminino;16;1;0;15
VILA RICA;Vereador;Masculino;40;8;0;32
VILA RICA;Vereador;Feminino;19;1;0;18
VILA VALÉRIO;Vereador;Masculino;54;9;0;45
VILA VALÉRIO;Vereador;Feminino;29;0;0;29
VILA VELHA;Vereador;Masculino;261;17;0;244
VILA VELHA;Vereador;Feminino;110;0;0;110
VILHENA;Vereador;Masculino;95;7;0;88
VILHENA;Vereador;Feminino;40;3;0;37
VINHEDO;Vereador;Masculino;125;13;0;112
VINHEDO;Vereador;Feminino;54;2;0;52
VIRADOURO;Vereador;Masculino;54;8;0;46
VIRADOURO;Vereador;Feminino;29;1;0;28
VIRGEM DA LAPA;Vereador;Masculino;38;7;0;31
VIRGEM DA LAPA;Vereador;Feminino;20;2;0;18
VIRGÍNIA;Vereador;Masculino;22;8;0;14
VIRGÍNIA;Vereador;Feminino;11;1;0;10
VIRGINÓPOLIS;Vereador;Masculino;66;8;0;58
VIRGINÓPOLIS;Vereador;Feminino;33;1;0;32
VIRGOLÂNDIA;Vereador;Masculino;22;8;0;14
VIRGOLÂNDIA;Vereador;Feminino;12;1;0;11
VIRMOND;Vereador;Masculino;32;7;0;25
VIRMOND;Vereador;Feminino;19;2;0;17
VISCONDE DO RIO BRANCO;Vereador;Masculino;49;8;0;41
VISCONDE DO RIO BRANCO;Vereador;Feminino;25;1;0;24
VISEU;Vereador;Masculino;48;9;0;39
VISEU;Vereador;Feminino;21;1;0;20
VISTA ALEGRE;Vereador;Masculino;17;8;0;9
VISTA ALEGRE;Vereador;Feminino;9;1;0;8
VISTA ALEGRE DO ALTO;Vereador;Masculino;42;9;0;33
VISTA ALEGRE DO ALTO;Vereador;Feminino;22;0;0;22
VISTA ALEGRE DO PRATA;Vereador;Masculino;12;6;0;6
VISTA ALEGRE DO PRATA;Vereador;Feminino;6;3;0;3
VISTA GAÚCHA;Vereador;Masculino;17;7;0;10
VISTA GAÚCHA;Vereador;Feminino;9;2;0;7
VISTA SERRANA;Vereador;Masculino;19;7;0;12
VISTA SERRANA;Vereador;Feminino;9;2;0;7
VITOR MEIRELES;Vereador;Masculino;22;8;0;14
VITOR MEIRELES;Vereador;Feminino;11;1;0;10
VITÓRIA;Vereador;Masculino;161;14;0;147
VITÓRIA;Vereador;Feminino;68;1;0;67
VITÓRIA BRASIL;Vereador;Masculino;23;8;0;15
VITÓRIA BRASIL;Vereador;Feminino;14;1;0;13
VITÓRIA DA CONQUISTA;Vereador;Masculino;215;19;0;196
VITÓRIA DA CONQUISTA;Vereador;Feminino;85;2;0;83
VITÓRIA DAS MISSÕES;Vereador;Masculino;16;7;0;9
VITÓRIA DAS MISSÕES;Vereador;Feminino;7;2;0;5
VITÓRIA DE SANTO ANTÃO;Vereador;Masculino;101;11;0;90
VITÓRIA DE SANTO ANTÃO;Vereador;Feminino;38;0;0;38
VITÓRIA DO JARI;Vereador;Masculino;60;7;0;53
VITÓRIA DO JARI;Vereador;Feminino;30;2;0;28
VITÓRIA DO MEARIM;Vereador;Masculino;70;6;0;64
VITÓRIA DO MEARIM;Vereador;Feminino;26;5;0;21
VITÓRIA DO XINGU;Vereador;Masculino;40;8;0;32
VITÓRIA DO XINGU;Vereador;Feminino;18;1;0;17
VITORINO;Vereador;Masculino;26;8;0;18
VITORINO;Vereador;Feminino;7;1;0;6
VITORINO FREIRE;Vereador;Masculino;50;11;0;39
VITORINO FREIRE;Vereador;Feminino;22;2;0;20
VOLTA GRANDE;Vereador;Masculino;33;7;0;26
VOLTA GRANDE;Vereador;Feminino;16;2;0;14
VOLTA REDONDA;Vereador;Masculino;302;20;0;282
VOLTA REDONDA;Vereador;Feminino;123;1;0;122
VOTORANTIM;Vereador;Masculino;145;10;0;135
VOTORANTIM;Vereador;Feminino;69;1;0;68
VOTUPORANGA;Vereador;Masculino;122;15;0;107
VOTUPORANGA;Vereador;Feminino;53;0;0;53
WAGNER;Vereador;Masculino;29;9;0;20
WAGNER;Vereador;Feminino;14;0;0;14
WALL FERRAZ;Vereador;Masculino;20;8;0;12
WALL FERRAZ;Vereador;Feminino;9;1;0;8
WANDERLÂNDIA;Vereador;Masculino;34;6;0;28
WANDERLÂNDIA;Vereador;Feminino;18;3;0;15
WANDERLEY;Vereador;Masculino;28;7;0;21
WANDERLEY;Vereador;Feminino;13;2;0;11
WENCESLAU BRAZ;Vereador;Masculino;90;17;0;73
WENCESLAU BRAZ;Vereador;Feminino;42;1;0;41
WENCESLAU GUIMARÃES;Vereador;Masculino;68;9;0;59
WENCESLAU GUIMARÃES;Vereador;Feminino;32;2;0;30
WESTFALIA;Vereador;Masculino;17;7;0;10
WESTFALIA;Vereador;Feminino;8;2;0;6
WITMARSUM;Vereador;Masculino;16;9;0;7
WITMARSUM;Vereador;Feminino;8;0;0;8
XAMBIOÁ;Vereador;Masculino;51;9;0;42
XAMBIOÁ;Vereador;Feminino;26;0;0;26
XAMBRÊ;Vereador;Masculino;28;9;0;19
XAMBRÊ;Vereador;Feminino;13;0;0;13
XANGRI-LÁ;Vereador;Masculino;44;8;0;36
XANGRI-LÁ;Vereador;Feminino;25;1;0;24
XANXERÊ;Vereador;Masculino;41;9;0;32
XANXERÊ;Vereador;Feminino;20;0;0;20
XAPURI;Vereador;Masculino;46;9;0;37
XAPURI;Vereador;Feminino;22;0;0;22
XAVANTINA;Vereador;Masculino;18;9;0;9
XAVANTINA;Vereador;Feminino;9;0;0;9
XAXIM;Vereador;Masculino;42;10;0;32
XAXIM;Vereador;Feminino;19;1;0;18
XEXÉU;Vereador;Masculino;34;7;0;27
XEXÉU;Vereador;Feminino;16;2;0;14
XINGUARA;Vereador;Masculino;98;11;0;87
XINGUARA;Vereador;Feminino;38;2;0;36
XIQUE-XIQUE;Vereador;Masculino;43;11;0;32
XIQUE-XIQUE;Vereador;Feminino;18;2;0;16
ZABELÊ;Vereador;Masculino;17;8;0;9
ZABELÊ;Vereador;Feminino;7;1;0;6
ZACARIAS;Vereador;Masculino;34;8;0;26
ZACARIAS;Vereador;Feminino;15;1;0;14
ZÉ DOCA;Vereador;Masculino;93;12;0;81
ZÉ DOCA;Vereador;Feminino;44;3;0;41
ZORTÉA;Vereador;Masculino;22;8;0;14
ZORTÉA;Vereador;Feminino;10;1;0;9
